  SH  SH  SH  SH  SE  SE  SE  SE  PI  PI  PI  PI  PI  PI  PI  PI  PI  PI  PI  SE  SE  SE  SH  SH  SH  SH  SH
  SH  MT  SH  SE  SE  SE  PI  PI  PI  SH  SH  SH  SH  SH  SH  SH  SH  SH  PI  PI  PI  SE  SE  SH  SH  MT  SH
  SH  SH  SH  SE  PI  PI  PI  SH  SH  SH  SP  GR  GR  FR  GR  GR  CT  SH  SH  SH  PI  PI  PI  SE  SH  SH  SH
  MT  SH  SE  PI  PI  SH  SH  SH  FR  GR  GR  GR  GR  GR  TW  GR  GR  FR  GR  SH  SH  SH  PI  PI  SE  SE  SH
  SH  SE  PI  PI  SH  SH  GR  CT  GR  GR  RD  CT  GR  GR  RD  GR  GR  GR  GR  GR  FR  SH  SH  PI  PI  SE  SE
  SE  SE  PI  SH  SH  GR  GR  GR  GR  RD  RD  GR  MT  CT  RD  RD  RD  GR 4FC  GR  GR  GR  SH  SH  PI  SE  SE
  SE  PI  PI  SH  BK  GR  GR  GR  FR  RD  GR  MT  GR  GR  SH  GR  CT  GR  GR  GR  GR 4FC  GR  SH  PI  PI  SE
  SE  PI  SH  SH  FR  GR15FC  MT  CT  GR  GR  GR  FR  GR  RD  GR  GR  MT  RD  GR  GR  MT  GR  SH  SH  PI  SE
  PI  PI  SH  GR  GR  GR  RD  RD  GR  SH15LB  RD  GR  GR  RD  FR  GR  CT  RD  RD  CT  GR  GR  FR  SH  PI  PI
  PI  SH  SH  GR  GR15FC  GR  RD  GR  SH  GR  RD  GR  CT  GR  RD  GR  SH  GR  GR  RD  GR  GR  GR  SH  SH  PI
  PI  SH  AP  GR  RV  GR  GR  RD  CT  GR  FR  RD  RD  GR  MT  GR  GR  GR  SP  GR  RD  RD  CT  GR  GR  SH  PI
  PI  SH  FR  GR  RV  FR  CT  RD  MT  GR  GR  CT  BR  RV  RV  CT  FR  RD  GR  GR  FR  RD  GR  GR  CT  SH  PI
  PI  SH  GR  CT  RV  GR  GR  GR  RD  GR  GR  RD  RD  GR  GR  GR  GR  RD  GR  SH  GR  RD  RD  GR  GR  SH  PI
  PI  SH  GR  GR  MT  CT  GR  SH  RD  CT  FR  SH  SH  FR  SH  SH  FR  CT  RD  SH  GR  CT  MT  GR  GR  SH  PI
  PI  SH  GR  GR  RD  RD  GR  SH  GR  RD  GR  GR  GR  GR  RD  RD  GR  GR  RD  GR  GR  GR  RV  CT  GR  SH  PI
  PI  SH  CT  GR  GR  RD  FR  GR  GR  RD  FR  CT  RV  RV  BR  CT  GR  GR  MT  RD  CT  FR  RV  GR  FR  SH  PI
  PI  SH  GR  GR  CT  RD  RD  GR  SP  GR  GR  GR  MT  GR  RD  RD  FR  GR  CT  RD  GR  GR  RV  GR  AP  SH  PI
  PI  SH  SH  GR  GR  GR  RD  GR  GR  SH  GR  RD  GR  CT  GR  RD  GR  SH  GR  RD  GR 4FC  GR  GR  SH  SH  PI
  PI  PI  SH  FR  GR  GR  CT  RD  RD  CT  GR  FR  RD  GR  GR  RD 4LB  SH  GR  RD  RD  GR  GR  GR  SH  PI  PI
  SE  PI  SH  SH  GR  MT  GR  GR  RD  MT  GR  GR  RD  GR  FR  GR  GR  GR  CT  MT 4FC  GR  FR  SH  SH  PI  SE
  SE  PI  PI  SH  GR15FC  GR  GR  GR  GR  CT  GR  SH  GR  GR  MT  GR  RD  FR  GR  GR  GR  BK  SH  PI  PI  SE
  SE  SE  PI  SH  SH  GR  GR  GR15FC  GR  RD  RD  RD  CT  MT  GR  RD  RD  GR  GR  GR  GR  SH  SH  PI  SE  SE
  SE  SE  PI  PI  SH  SH  FR  GR  GR  GR  GR  GR  RD  GR  GR  CT  RD  GR  GR  CT  GR  SH  SH  PI  PI  SE  SH
  SH  SE  SE  PI  PI  SH  SH  SH  GR  FR  GR  GR  TW  GR  GR  GR  GR  GR  FR  SH  SH  SH  PI  PI  SE  SH  MT
  SH  SH  SH  SE  PI  PI  PI  SH  SH  SH  CT  GR  GR  FR  GR  GR  SP  SH  SH  SH  PI  PI  PI  SE  SH  SH  SH
  SH  MT  SH  SH  SE  SE  PI  PI  PI  SH  SH  SH  SH  SH  SH  SH  SH  SH  PI  PI  PI  SE  SE  SE  SH  MT  SH
  SH  SH  SH  SH  SH  SE  SE  SE  PI  PI  PI  PI  PI  PI  PI  PI  PI  PI  PI  SE  SE  SE  SE  SH  SH  SH  SH

15, INFANTRY, 6, 8
15, INFANTRY, 7, 20