  MT  MT  FR  GR  CT  MT  GR  FC  RD  MT  RV  RV  GR  GR  SP  SE  SE  SE  SE
  MT  AP  GR  MT  MT  RD  RD  RD  RD  FR  BR  BK  FR  GR  MT  SH  SH  SH  CT
  GR  RD  RD  RD 3FC  RD  CT  FR  GR  CT  BR  GR  GR  GR  GR  RD  RD  RD  RD
 3FC  RD  MT  MT  FR  RV  RV  BR  BR  RV  RV  GR  CT  RD  RD  RD  FR  GR  GR
  GR  GR  FR  MT  CT  RV  GR  BK  GR  GR  GR  GR  MT  GR  GR  GR  GR  LB  GR
  FR  CT  GR  RV  BR  RV  FR  GR  MT  GR  FR  RD  RD  RD  GR  CT  GR  RD  RD
  RV  BR  RV  RV  GR  GR  GR  GR  GR  GR 3HQ  RD  FR  RD  RD  RD  RD  RD  CT
  RD  RD  GR  FR  GR  GR  CT  RD  RD  RD  RD  RD  GR  GR  GR  GR  FR  RD  RD
  CT  GR  RD  RD  RD  RD  MT  RD  BK  GR  FR  GR  CT  GR  FR  GR  GR  MT  GR
  RD  RD  RD  TW  GR  RD  RD  RD  GR  GR  GR  RD  RD  RD  GR  TW  RD  RD  RD
  GR  MT  GR  GR  FR  GR  CT  GR  FR  GR  BK  RD  MT  RD  RD  RD  RD  GR  CT
  RD  RD  FR  GR  GR  GR  GR  RD  RD  RD  RD  RD  CT  GR  GR  FR  GR  RD  RD
  CT  RD  RD  RD  RD  RD  FR  RD 6HQ  GR  GR  GR  GR  GR  GR  RV  RV  BR  RV
  RD  RD  GR  CT  GR  RD  RD  RD  FR  GR  MT  GR  FR  RV  BR  RV  GR  CT  FR
  GR  LB  GR  GR  GR  GR  MT  GR  GR  GR  GR  BK  GR  RV  CT  MT  FR  GR  GR
  GR  GR  FR  RD  RD  RD  CT  GR  RV  RV  BR  BR  RV  RV  FR  MT  MT  RD 6FC
  RD  RD  RD  RD  GR  GR  GR  GR  BR  CT  GR  FR  CT  RD 6FC  RD  RD  RD  GR
  CT  SH  SH  SH  MT  GR  FR  BK  BR  FR  RD  RD  RD  RD  MT  MT  GR  AP  MT
  SE  SE  SE  SE  SP  GR  GR  RV  RV  MT  RD  FC  GR  MT  CT  GR  FR  MT  MT
team, unit type, x, y (author: FoW Maps)
6, bboat, 8, 12
3, bboat, 10, 6
6, infantry, 14, 16
