  FR  FR  FR  FR  FR  FR  FR  FR  SH  SH  SH  SH  SH  SH  SH  SH  SH  SH  SH  SH  FR  FR  FR  FR  FR  FR  FR  FR
  FR  FR  FR  FR  FR  FR  SH  SH  SH  SE  SH  BK  FR  RD  FC  FR  FR  SH  SH  SH  SH  SH  FR  FR  FR  FR  FR  FR
  FR  FR  FR  FR  FR  SH  SH  SH  FR  RV  CT  RD  RD  RD  FR  FR  FR  FR  FR  FR  SH  SH  SH  FR  FR  FR  FR  FR
  FR  FR  FR  FR  SH  SH  FR  FR  FR  RV  RV  RD  FR  FR  FR  FR  FR  FR  FR  FR  FR  BK  SH  SH  FR  FR  FR  FR
  FR  FR  FR  SH  SH  AP  FR  FR  FR  FR  RV  BR  BR  RV  CT  GR  FR  FR  FR  FR  FR  FR  FR  SH  SH  FR  FR  FR
  FR  FR  SH  SH  FR  FR  FR  GR  CT  FR  GR12FC  GR  RV  RV  BR  RV  CT  FR  FR  FR  TW  FR  FR  SH  SH  FR  FR
  FR  SH  SH  FR  BK  RD  RD  RD  GR  GR  GR  GR  BK  GR  GR  GR  FR  GR  GR  MT  FR  FR  BK  FR  FR  SH  SH  FR
  FR  SH  SH  FR  FR  FR  FR12FC  GR  CT  GR  MT  GR  CT  GR  MT12HQ  GR  RD  CT  BK  FR  FR  BK  FR  SH  SH  FR
  SH  SH  FR  FR  FR  FR  GR  RD  SH  SH  FR  GR  MT  RD  RD  GR  GR  RD  RD  GR  GR  GR  BK  FR  FR  FR  SH  SH
  SH  SH  FR  SH  SH  BK  RD  RD  SH  RF  SH  GR  GR  FR  RD  RD  CT  RD  MT  RD  RD  RD  FR  FR  FR  FR  SH  SH
  SH  SH  FR  SH  SH  MT  RD  GR  FR  SH  SH  GR  CT  GR  GR  GR  GR  RD  RD  RD  CT  RD  MT  FR  FR  BK  SH  SH
  SH  FR  FR  GR  MT  BK  RD  CT  MT  TW  RD  RD  RD  GR  BK  RD  GR  GR  GR  GR  BK  RD  RD  RD  FR  FR  FR  SH
  SH  FR  FR  FR  AP  RD  GR  MT  MT  RD  RD  FR  GR  GR  MT  RD  GR  FR  GR  GR  GR  GR  GR  CT  FR  FR  FR  SH
  SH  FR  FR  FR  GR  GR  GR  MT  GR  RD  GR  GR  GR  RD  RD  CT  GR  GR  RD  CT  GR  FR  GR  MT  FR  FR  FR  SH
  SH  FR  FR  FR  MT  GR  FR  GR  CT  RD  GR  GR  CT  RD  RD  GR  GR  GR  RD  GR  MT  GR  GR  GR  FR  FR  FR  SH
  SH  FR  FR  FR  CT  GR  GR  GR  GR  GR  FR  GR  RD  MT  GR  GR  FR  RD  RD  MT  MT  GR  RD  AP  FR  FR  FR  SH
  SH  FR  FR  FR  RD  RD  RD  BK  GR  GR  GR  GR  RD  BK  GR  RD  RD  RD  TW  MT  CT  RD  BK  MT  GR  FR  FR  SH
  SH  SH  BK  FR  FR  MT  RD  CT  RD  RD  RD  GR  GR  GR  GR  CT  GR  SH  SH  FR  GR  RD  MT  SH  SH  FR  SH  SH
  SH  SH  FR  FR  FR  FR  RD  RD  RD  MT  RD  CT  RD  RD  FR  GR  GR  SH  RF  SH  RD  RD  BK  SH  SH  FR  SH  SH
  SH  SH  FR  FR  FR  BK  GR  GR  GR  RD  RD  GR  GR  RD  RD  MT  GR  FR  SH  SH  RD  GR  FR  FR  FR  FR  SH  SH
  FR  SH  SH  FR  BK  FR  FR  BK  CT  RD  GR 4HQ  MT  GR  CT  GR  MT  GR  CT  GR 4FC  FR  FR  FR  FR  SH  SH  FR
  FR  SH  SH  FR  FR  BK  FR  FR  MT  GR  GR  FR  GR  GR  GR  BK  GR  GR  GR  GR  RD  RD  RD  BK  FR  SH  SH  FR
  FR  FR  SH  SH  FR  FR  TW  FR  FR  FR  CT  RV  BR  RV  RV  GR 4FC  GR  FR  CT  GR  FR  FR  FR  SH  SH  FR  FR
  FR  FR  FR  SH  SH  FR  FR  FR  FR  FR  FR  FR  GR  CT  RV  BR  BR  RV  FR  FR  FR  FR  AP  SH  SH  FR  FR  FR
  FR  FR  FR  FR  SH  SH  BK  FR  FR  FR  FR  FR  FR  FR  FR  FR  RD  RV  RV  FR  FR  FR  SH  SH  FR  FR  FR  FR
  FR  FR  FR  FR  FR  SH  SH  SH  FR  FR  FR  FR  FR  FR  RD  RD  RD  CT  RV  FR  SH  SH  SH  FR  FR  FR  FR  FR
  FR  FR  FR  FR  FR  FR  SH  SH  SH  SH  SH  FR  FR  FC  RD  FR  BK  SH  SE  SH  SH  SH  FR  FR  FR  FR  FR  FR
  FR  FR  FR  FR  FR  FR  FR  FR  SH  SH  SH  SH  SH  SH  SH  SH  SH  SH  SH  SH  FR  FR  FR  FR  FR  FR  FR  FR
team, unit type, x, y (author: Everdan)
12, infantry, 11, 5
