  MT  FR  AP  FR  CT  RD  BR 0FC  BR  RD  GR  CT 0HQ  CT  RD  RD  RD 0FC  RD  RD  AP  RD  RD  MT
  MT  FR  RD  RD  RD  FR  RV  RV  RV  FR  MT  GR  GR  GR  FR  MT  FR  MT  MT  FR  MT  MT  RD  RD
  MT  RD  RD  GR  MT  GR  GR  CT  GR  GR  FR  FC  GR  MT  FR  GR  CT  GR  GR  FR  GR  MT  RD  RD
  RD  RD  MT  GR  GR  MT  FR  GR  MT  GR  SE  SE  SE  CT  GR  GR  GR  MT  GR  BK  GR  RD  RD  CT
  RD  MT  CT  GR  GR  MT  GR  RD  CT  RD  GR  SE  GR  GR  GR  GR  MT  GR  GR  GR  GR  RD  GR  GR
  RD  GR  GR  GR  RD  RD  GR  RD  SP  RD  GR  MT  GR  GR  GR  GR  GR  FR  MT  GR  RD  RD  GR  GR
  RD  CT  MT  GR  RD  TW  FR  RD  RD  RD  FR  GR  FR  FR  GR  RD  CT  GR  FR  GR  RD  CT  FR  GR
  FR  RD  GR  GR  GR  GR  GR  GR  GR  GR  FR  RD  CT  GR  FR  RD  RD  CT  GR  MT  CT  RD  RD  FR
  FR  RD  RD  CT  MT  GR  CT  RD  RD  FR  GR  CT  RD  FR  GR  GR  GR  GR  GR  GR  GR  GR  RD  FR
  GR  FR  CT  RD  GR  FR  GR  CT  RD  GR  FR  FR  GR  FR  RD  RD  RD  FR  TW  RD  GR  MT  CT  RD
  GR  GR  RD  RD  GR  MT  FR  GR  GR  GR  GR  GR  MT  GR  RD  SP  RD  GR  RD  RD  GR  GR  GR  RD
  GR  GR  RD  GR  GR  GR  GR  MT  GR  GR  GR  GR  SE  GR  RD  CT  RD  GR  MT  GR  GR  CT  MT  RD
  CT  RD  RD  GR  BK  GR  MT  GR  GR  GR  CT  SE  SE  SE  GR  MT  GR  FR  MT  GR  GR  MT  RD  RD
  RD  RD  MT  GR  FR  GR  GR  CT  GR  FR  MT  GR  FC  FR  GR  GR  CT  GR  GR  MT  GR  RD  RD  MT
  RD  RD  MT  MT  FR  MT  MT  FR  MT  FR  GR  GR  GR  MT  FR  RV  RV  RV  FR  RD  RD  RD  FR  MT
  MT  RD  RD  AP  RD  RD 1FC  RD  RD  RD  CT 1HQ  CT  GR  RD  BR 1FC  BR  RD  CT  FR  AP  FR  MT
team, unit type, x, y (author: Rush_FTK)
1, infantry, 16, 15
