  SH  RD  SH  SH  SH  GR  CT  RD  GR  GR  GR  FR  RD  GR  GR  CT  GR  RD  GR  GR  CT  FR
  CT  RD  GR  GR  GR  GR  GR  RD  MT  GR  GR  GR  AP  GR  GR  FR  GR  CT  RD  RD  GR  GR
  GR  RD  RD  CT  FR  FR  GR  RD  RD13FC  GR  GR  RD  RD  GR  GR  GR  SE  GR  RD  RD  RD
  FR  GR  GR  RD  GR  GR  GR  GR  GR  CT  GR  GR  GR  CT  GR  GR  GR  SP  FR  FR  GR  CT
  CT  MT  GR  FC  RD  RD  GR  GR  GR  GR  GR  GR  GR  RD  RD  SH  SH  SE  GR  GR  GR  GR
  MT  GR  GR  GR  GR  RD  GR  CT13HQ  GR  MT  CT  GR  FR  RD  SH  RD  RD  GR  CT  GR  GR
  RD  RD  GR  GR  GR  RD  RD  RD  FR  GR  GR  RD  GR  GR  SE  SE  GR  RD  RD  RD  GR  GR
  GR13FC  GR  GR  GR  CT  GR  GR  GR  CT  GR  RD  RD  GR  SH  CT  GR  GR  GR  RD  FR  CT
  GR  RD  RD  MT  MT  GR  GR  GR  GR  GR  SH  SH  GR  GR  GR  GR  GR  MT  MT  RD  RD  GR
  CT  FR  RD  GR  GR  GR  CT  SH  GR  RD  RD  GR  CT  GR  GR  GR  CT  GR  GR  GR 5FC  GR
  GR  GR  RD  RD  RD  GR  SE  SE  GR  GR  RD  GR  GR  FR  RD  RD  RD  GR  GR  GR  RD  RD
  GR  GR  CT  GR  RD  RD  SH  RD  FR  GR  CT  MT  GR 5HQ  CT  GR  RD  GR  GR  GR  GR  MT
  GR  GR  GR  GR  SE  SH  SH  RD  RD  GR  GR  GR  GR  GR  GR  GR  RD  RD  FC  GR  MT  CT
  CT  GR  FR  FR  SP  GR  GR  GR  CT  GR  GR  GR  CT  GR  GR  GR  GR  GR  RD  GR  GR  FR
  RD  RD  RD  GR  SE  GR  GR  GR  RD  RD  GR  GR 5FC  RD  RD  GR  FR  FR  CT  RD  RD  GR
  GR  GR  RD  RD  CT  GR  FR  GR  GR  AP  GR  GR  GR  MT  RD  GR  GR  GR  GR  GR  RD  CT
  FR  CT  GR  GR  RD  GR  CT  GR  GR  RD  FR  GR  GR  GR  RD  CT  GR  SH  SH  SH  RD  SH
team, unit type, x, y (author: PikachuDX)
13, infantry, 1, 7
