  MT  GR  RD  RD  GR  RD  CT  RD  MT  GR  CT  SE  SH  RD  RD  RD  RD  RD  RD
  GR  CT  GR  FR  GR  RD  GR  GR  GR  FR  GR  SH  SH  GR  FC  FR  GR  GR 7FC
  SH  RV  GR  GR  CT  RD  FR  SH  SH  GR  MT  GR  FR  GR  RD  GR  GR  MT  RD
  RD  BR  RD  RD  GR  GR  GR  SH  SH  GR  GR  CT  RD  MT  RD  RD 7FC  RD  RD
  GR  RV  CT  RD  FR  BK  GR  GR  TW  GR  FR  GR  RD  RD  RD  GR  FR  GR  RD
  GR  SH  GR  GR  GR  CT  GR  FR  RD  RD  RD  GR  GR  FR  GR  CT  GR  GR  CT
  FR  SH  SE  GR  SH  SH  SH  GR  GR  GR  RD  GR  CT  RD  MT  GR  GR  MT  RD
  GR  SH  SE  SP  SH  SE  SH  CT  BK  FR  GR  GR  GR  RD  RD  FR  GR  AP  RD
  CT  GR  MT  GR  SH  SH  SH  GR  GR  GR  CT  GR  FR  GR  CT  RD  GR  GR  RD
  RD  FR 2HQ  RD  GR  GR  GR  GR  BK  BR  BK  GR  GR  GR  GR  RD 7HQ  FR  RD
  RD  GR  GR  RD  CT  GR  FR  GR  CT  GR  GR  GR  SH  SH  SH  GR  MT  GR  CT
  RD  AP  GR  FR  RD  RD  GR  GR  GR  FR  BK  CT  SH  SE  SH  SP  SE  SH  GR
  RD  MT  GR  GR  MT  RD  CT  GR  RD  GR  GR  GR  SH  SH  SH  GR  SE  SH  FR
  CT  GR  GR  CT  GR  FR  GR  GR  RD  RD  RD  FR  GR  CT  GR  GR  GR  SH  GR
  RD  GR  FR  GR  RD  RD  RD  GR  FR  GR  TW  GR  GR  BK  FR  RD  CT  RV  GR
  RD  RD 2FC  RD  RD  MT  RD  CT  GR  GR  SH  SH  GR  GR  GR  RD  RD  BR  RD
  RD  MT  GR  GR  RD  GR  FR  GR  MT  GR  SH  SH  FR  RD  CT  GR  GR  RV  SH
 2FC  GR  GR  FR  FC  GR  SH  SH  GR  FR  GR  GR  GR  RD  GR  FR  GR  CT  GR
  RD  RD  RD  RD  RD  RD  SH  SE  CT  GR  MT  RD  CT  RD  GR  RD  RD  GR  MT
team, unit type, x, y (author: Sami-YXL)
2, bboat, 4, 8
7, bboat, 14, 10
7, infantry, 18, 1
