  RD  CT  RD  GR  GR  RD  CT  RD  GR  GR  CT  GR  FR  RD  CT  BR 7FC  BR  RD  RD  AP  MT
  RD  MT  RD  CT  GR  GR  GR  FR  GR  BK  GR  GR  GR  MT  GR  RV  RV  RV  GR  RD  RD  RD
  RD  GR  GR  GR  FR  GR  GR  RD  CT  GR  FR  GR  CT  GR  FR  RD  ME  RD  FC  GR  RV  BR
  CT  GR  BK  GR  GR  CT  GR  RD  GR  RD  RD  GR  RD  RD  BR  RD  RV  ME  RV  SH  RV 7FC
  GR  FR 2HQ  GR  GR  GR  FR  GR  GR  GR  GR  TW  GR  GR  GR  RD  CT  RD  SH  GR  MT  RD
  GR  GR  GR  FR  RD  RD  GR  CT  GR  FR  RD  RD  GR  CT  RV  GR  GR  GR  RV  CT  GR  FR
  SH  SH  SH  SH  CT  SH  SH  SH  SH  GR  GR  GR  GR  SH  SH  SH  SH  FR  SH  SH  SH  SH
  SH  CT  SE  SE  SE  SE  SH  SE  SH  CT  SH  SH  SE  SH  SE  SP  SE  GR  SH  SE  SE  SH
  SH  SE  SE  SH  GR  SE  SP  SE  SH  SE  SH  SH  CT  SH  SE  SH  SE  SE  SE  SE  CT  SH
  SH  SH  SH  SH  FR  SH  SH  SH  SH  GR  GR  GR  GR  SH  SH  SH  SH  CT  SH  SH  SH  SH
  FR  GR  CT  RV  GR  GR  GR  RV  CT  GR  RD  RD  FR  GR  CT  GR  RD  RD  FR  GR  GR  GR
  RD  MT  GR  SH  RD  CT  RD  GR  GR  GR  TW  GR  GR  GR  GR  FR  GR  GR  GR 7HQ  FR  GR
 2FC  RV  SH  RV  ME  RV  RD  BR  RD  RD  GR  RD  RD  GR  RD  GR  CT  GR  GR  BK  GR  CT
  BR  RV  GR  FC  RD  ME  RD  FR  GR  CT  GR  FR  GR  CT  RD  GR  GR  FR  GR  GR  GR  RD
  RD  RD  RD  GR  RV  RV  RV  GR  MT  GR  GR  GR  BK  GR  FR  GR  GR  GR  CT  RD  MT  RD
  MT  AP  RD  RD  BR 2FC  BR  CT  RD  FR  GR  CT  GR  GR  RD  CT  RD  GR  GR  RD  CT  RD
team, unit type, x, y (author: Sami-YXL)
2, bboat, 2, 4
7, infantry, 16, 0
7, bboat, 19, 11
