  GR  CT  MT  GR  PI  GR  GR  CT  GR  BK  GR  CT  GR  GR  FR  GR  MT  CT
  GR  RD  RD  AP  PI  RD  RD  RD  FR  CT  RD  GR  RD  RD  RD  RD  GR  GR
  FR  RD  GR  PI  PI  CT  FR  RD  GR  GR  RD  BK  RD  GR  CT  RD  RD  GR
  GR  RD  GR  SH  RV  RV  BR  BR  RV  SH  GR  GR  FR  GR  MT  GR  RD12FC
  GR  CT  RV  RV13HQ  GR  CT  RD  MT  RV  SH  GR  GR  CT  GR  RD  RD  GR
  MT  RD  BR  RD  GR  FR  GR  RD  GR  GR  RV  TW  GR  GR  GR  RD  CT  GR
  GR  RD  RV  RD  RD  MT  RD  RD  FR  CT  GR  GR  GR  PI  RV  BR  RV  PI
  RD13FC  RV  CT  RD  GR  RD  CT  GR  GR  BK  MT  GR  GR  RD  RD  RD  CT
  BR  RV  SH  FR  RD  GR  RD  RD  GR  FR  RD  GR  CT  RD  RD  FR  RD  RD
  RD  RD  FR  RD  RD  CT  GR  RD  FR  GR  RD  RD  GR  RD  FR  SH  RV  BR
  CT  RD  RD  RD  GR  GR  MT  BK  GR  GR  CT  RD  GR  RD  CT  RV12FC  RD
  PI  RV  BR  RV  PI  GR  GR  GR  CT  FR  RD  RD  MT  RD  RD  RV  RD  GR
  GR  CT  RD  GR  GR  GR  TW  RV  GR  GR  RD  GR  FR  GR  RD  BR  RD  MT
  GR  RD  RD  GR  CT  GR  GR  SH  RV  MT  RD  CT  GR12HQ  RV  RV  CT  GR
13FC  RD  GR  MT  GR  FR  GR  GR  SH  RV  BR  BR  RV  RV  SH  GR  RD  GR
  GR  RD  RD  CT  GR  RD  BK  RD  GR  GR  RD  FR  CT  PI  PI  GR  RD  FR
  GR  GR  RD  RD  RD  RD  GR  RD  CT  FR  RD  RD  RD  PI  AP  RD  RD  GR
  CT  MT  GR  FR  GR  GR  CT  GR  BK  GR  CT  GR  GR  PI  GR  MT  CT  GR
team, unit type, x, y (author: SuKo02)
13, infantry, 1, 7
