  RD  CT  RD  GR  GR  CT  GR  FR  RD  MT  GR  FR  GR  GR  CT  GR  RD  SE  SE  RF
  GR  GR  RD  RD  FR  GR  GR  GR  RD  RD  CT  GR  RD  RD  RD  RD  RD  MT  AP  SE
  MT  FR  GR  CT  GR  GR  SH  TW  GR  FR  GR  GR  SP  SH  PI  ME  ME  PI  MT  SE
  GR  GR  RD  RD  GR  SE  SE  SH  GR  BK  PI  PI  SE  SE  PI 6FC  RD  PI  RD  RD
  GR  CT  RD  GR  SE  SE  SE  GR  GR  GR  GR  FR  CT  SH  MT  GR 6FC  GR  RD  FR
  FR  GR  GR  SH  SE  SE  GR  CT  FR  GR 6HQ  RD  RD  SH  SH  MT  PI  PI  BR  SE
  GR  RD  RD  SP  SH  FR  RD  RD  GR  GR  GR  GR  RD  RD  SH  SH  SE  SH  FC  SH
  CT  RD  FR  GR  GR  RD  RD  GR  GR  GR  FR  GR  MT  RD  RD  GR  PI  GR  FR  SH
  GR  RD  GR  BK  GR  CT  GR  GR  FR  CT  GR  GR  GR  GR  RD  CT  PI  GR  CT  SH
  FR  RD  CT  RD  GR  GR  FR  GR  GR  SH  SH  GR  CT  RD  RD  GR  MT  GR  GR  GR
  GR  GR  GR  MT  GR  RD  RD  CT  GR  SH  SH  GR  GR  FR  GR  GR  RD  CT  RD  FR
  SH  CT  GR  PI  CT  RD  GR  GR  GR  GR  CT  FR  GR  GR  CT  GR  BK  GR  RD  GR
  SH  FR  GR  PI  GR  RD  RD  MT  GR  FR  GR  GR  GR  RD  RD  GR  GR  FR  RD  CT
  SH  FC  SH  SE  SH  SH  RD  RD  GR  GR  GR  GR  RD  RD  FR  SH  SP  RD  RD  GR
  SE  BR  PI  PI  MT  SH  SH  RD  RD 3HQ  GR  FR  CT  GR  SE  SE  SH  GR  GR  FR
  FR  RD  GR 3FC  GR  MT  SH  CT  FR  GR  GR  GR  GR  SE  SE  SE  GR  RD  CT  GR
  RD  RD  PI  RD 3FC  PI  SE  SE  PI  PI  BK  GR  SH  SE  SE  GR  RD  RD  GR  GR
  SE  MT  PI  ME  ME  PI  SH  SP  GR  GR  FR  GR  TW  SH  GR  GR  CT  GR  FR  MT
  SE  AP  MT  RD  RD  RD  RD  RD  GR  CT  RD  RD  GR  GR  GR  FR  RD  RD  GR  GR
  RF  SE  SE  RD  GR  CT  GR  GR  FR  GR  MT  RD  FR  GR  CT  GR  GR  RD  CT  RD
team, unit type, x, y (author: FoW Maps)
3, artillery, 2, 17
6, infantry, 16, 4
6, artillery, 17, 2
