  AP  GR 5FC  SE  RD  CT  GR  RD  CT  RD  RD  GR  CT  RD  RD  CT  RD
  GR  CT  FR  BR  RD  FR  GR  FR  GR  GR  RD  GR  GR  GR  FR  GR  RD
 5FC  FR  FC  RV  FR  GR  CT  GR  GR  RD  RD  TW  GR  GR  GR  BK  GR
  SE  BR  RV  RV  GR  RD  RD  GR  RD  CT  GR  GR  GR  CT  RD  RD  RD
  RD  RD  FR  GR  CT  RD  GR  CT  RD  GR  RD  FR  RD  RD  RD  FR  CT
  CT  FR  GR  RD  RD  FR  RD  RD  GR  GR  CT  GR  RD  GR  GR  GR  GR
  GR  GR  CT  RD  GR  RD  CT  GR  RD  RD  RD  GR  CT  GR  RD  RD  RD
  RD  GR  GR  FR  CT  RD  GR  RD  RD  FR  GR  GR  FR14HQ  RD  FR  RD
  CT  GR  GR  RD  RD  GR  GR  RD  LB  RD  GR  GR  RD  RD  GR  GR  CT
  RD  FR  RD 5HQ  FR  GR  GR  FR  RD  RD  GR  RD  CT  FR  GR  GR  RD
  RD  RD  RD  GR  CT  GR  RD  RD  RD  GR  CT  RD  GR  RD  CT  GR  GR
  GR  GR  GR  GR  RD  GR  CT  GR  GR  RD  RD  FR  RD  RD  GR  FR  CT
  CT  FR  RD  RD  RD  FR  RD  GR  RD  CT  GR  RD  CT  GR  FR  RD  RD
  RD  RD  RD  CT  GR  GR  GR  CT  RD  GR  RD  RD  GR  RV  RV  BR  SE
  GR  BK  GR  GR  GR  TW  RD  RD  GR  GR  CT  GR  FR  RV  FC  FR14FC
  RD  GR  FR  GR  GR  GR  RD  GR  GR  FR  GR  FR  RD  BR  FR  CT  GR
  RD  CT  RD  RD  CT  GR  RD  RD  CT  RD  GR  CT  RD  SE14FC  GR  AP
team, unit type, x, y (author: Kantbei)
14, infantry, 15, 15
