  SE  SE  SE  SE  SE  SE  SE  SE  SE  SE  SE  SE  SE  SE  SE  SE
  SE  SE  SE  SE  SE  GR  GR  SE  SE  SE  GR  MT  SE  SE  SE  SE
  SE  SE  GR  GR  MT  FR  FR  FR  FR  FR  FR  MT  MT  GR  SE  SE
  SE  GR  GR  MT  MT  GR  GR  GR  GR  GR  GR  MT  MT  GR  GR  SE
  SE 0CT 0CT  MT  MT  CT  CT  CT  CT  CT  CT  MT  MT 1CT 1CT  SE
  SE  GR  GR  GR  MT  RD  RD  RD  RD  RD  RD  MT  GR  GR  GR  SE
  SE 0FC  GR 0FC  MT  RD  GR  MT  MT  GR  RD  MT 1FC  GR 1FC  SE
  SE 0HQ 0FC  RD  MT  RD 0CT  MT  MT 1CT  RD  MT  RD 1FC 1HQ  SE
  SE 0FC  FR  RD  MT  RD  GR  MT  MT  GR  RD  MT  RD  FR 1FC  SE
  SE  GR  GR  RD  RD  RD 0CT  MT  MT 1CT  RD  RD  RD  GR  GR  SE
  SE 0CT 0CT  GR  FR  FR  MT  MT  MT  MT  FR  FR  FR 1CT 1CT  SE
  SE  SE  SE  GR  GR  GR  GR  GR  SE  GR  GR  GR  MT  GR  SE  SE
  SE  SE  SE  SE  GR  GR  SE  SE  SE  SE  SE  GR  SE  SE  SE  SE
  SE  SE  SE  SE  SE  SE  SE  SE  SE  SE  SE  SE  SE  SE  SE  SE
  SE  SE  SE  SE  SE  SE  SE  SE  SE  SE  SE  SE  SE  SE  SE  SE
