  SE  SE  SE  SE  MT  GR  CT  SH  SH  SH  SE  SE  SE  SE  SE  RF  SE  SE  SE  SE  SE  SE  SE  SE  SE  RF  SE  SE  SE  SE
  SE  SE  GR  CT  GR  GR  GR  RD  FR  RD  CT  SH  SE  FR  SE  SE  SE  SE  RF  SE  SE  GR  SH 2FC  SH  SE  SE  FR  SE  SE
  SE  FR  GR  GR 0HQ  RD  RD  RD  GR  GR  GR  GR  SH  GR  GR  SE  SE  SE  SE  SE  SH  SH  SH  SH  SH  CT  SH  GR  GR  SE
  SE  SE  SH  RD  RD  FR  GR  CT  SE  SH  GR  RD  SH  RD  GR  GR  SE  SE  SE  SH  SH  SH  CT  SH  SH  SH  RD  GR  CT  SE
  RF  SE  CT  SH  SH  SH  SE  SE  SE  SE  SH  SH  SH  CT  RD  GR  SH  SE  SE  SP  SH  SH  SE  SE  CT  SH  RD 2HQ  GR  MT
  SE  SH  SH  SH  CT  RF  SE  SE  SE  SE  SE  SE  MT  GR  RD  AP  SH  SE  SE  SE  SH  SE  SE  SE  RF  SH  FR  RD  GR  GR
  SE 0FC  SH  SH  SE  SE  SE  CT  RD  FR  SE  SH  SH  RD  RD  GR  SH  SE  SE  RF  SE  SE  SE  SE  SE  SE  GR  RD  GR  CT
  SE  SH  SH  CT  SE  SE  SE  GR  GR  GR  RD 3FC  RD  RD  FR  GR  SE  SE  SE  SE  SE  SH  GR  CT  SE  SE  CT  RD  RD  SH
  SE  GR  SH  SH  SH  SE  SE  SH  GR  CT  RD  GR  GR  CT  GR  SE  SE  SE  SE  SE  SH  GR  GR  RD  SE  SE  SE  GR  FR  SH
  SE  SE  SH  SH  SH  SH  SE  SE  SH  GR  GR  FR  SH  SE  SE  SE  RF  SE  SP  SE  GR  CT  GR  FR  SE  SE  SH  GR  RD  SH
  SE  SE  SE  SH  SP  SE  RF  SE  SE  SE  SE  SE  SE  SE  SE  SH  SH  SE  SE  SE  GR  RD  RD  SE  SE  SH  GR  GR  CT  SE
  SE  RF  SE  SE  SE  SE  SE  SE  SE  SP  SE  SE  SE  SE  FR  SH  SH  SH  SE  SE  FR  GR 0FC  SH  SE  SH  RD  GR  SH  SE
  SE  SE  SE  SE  SE  SE  SE  SE  SE  SE  SE  SH  CT  GR  SH  SH  SH  CT  SE  SE  SH  GR  RD  SH  MT  SH  SH  SH  SE  SE
  SE  SE  SE  SE  SH  SH  SH  SE  SE  RF  SH  SH  SH  GR  CT  SH  GR  GR  SE  SE  SE  CT  RD  RD  GR  CT  RD  GR  FR  SE
  RF  SE  SE  GR  GR  AP  GR  GR  SE  SE  SH  SH  SH  SH  SH  SH  CT  SH  FR  SE  SE  GR  FR  RD  RD  RD  GR  GR  SE  SE
  SE  SE  GR  GR  RD  RD  RD  FR  GR  SE  SE  FR  SH  CT  SH  SH  SH  SH  SH  SH  SE  SE  GR  GR  AP  GR  GR  SE  SE  RF
  SE  FR  GR  RD  CT  GR  RD  RD  CT  SE  SE  SE  GR  GR  SH  CT  GR  SH  SH  SH  RF  SE  SE  SH  SH  SH  SE  SE  SE  SE
  SE  SE  SH  SH  SH  MT  SH  RD  GR  SH  SE  SE  CT  SH  SH  SH  GR  CT  SH  SE  SE  SE  SE  SE  SE  SE  SE  SE  SE  SE
  SE  SH  GR  RD  SH  SE  SH 1FC  GR  FR  SE  SE  SH  SH  SH  FR  SE  SE  SE  SE  SP  SE  SE  SE  SE  SE  SE  SE  RF  SE
  SE  CT  GR  GR  SH  SE  SE  RD  RD  GR  SE  SE  SE  SH  SH  SE  SE  SE  SE  SE  SE  SE  SE  RF  SE  SP  SH  SE  SE  SE
  SH  RD  GR  SH  SE  SE  FR  GR  CT  GR  SE  SP  SE  RF  SE  SE  SE  SH  FR  GR  GR  SH  SE  SE  SH  SH  SH  SH  SE  SE
  SH  FR  GR  SE  SE  SE  RD  GR  GR  SH  SE  SE  SE  SE  SE  GR  CT  GR  GR  RD  CT  GR  SH  SE  SE  SH  SH  SH  GR  SE
  SH  RD  RD  CT  SE  SE  CT  GR  SH  SE  SE  SE  SE  SE  GR  FR  RD  RD 2FC  RD  GR  GR  GR  SE  SE  SE  CT  SH  SH  SE
  CT  GR  RD  GR  SE  SE  SE  SE  SE  SE  RF  SE  SE  SH  GR  RD  RD  SH  SH  SE  FR  RD  CT  SE  SE  SE  SH  SH 1FC  SE
  GR  GR  RD  FR  SH  RF  SE  SE  SE  SH  SE  SE  SE  SH  AP  RD  GR  MT  SE  SE  SE  SE  SE  SE  RF  CT  SH  SH  SH  SE
  MT  GR 3HQ  RD  SH  CT  SE  SE  SH  SH  SP  SE  SE  SH  GR  RD  CT  SH  SH  SH  SE  SE  SE  SE  SH  SH  SH  CT  SE  RF
  SE  CT  GR  RD  SH  SH  SH  CT  SH  SH  SH  SE  SE  SE  GR  GR  RD  SH  RD  GR  SH  SE  CT  GR  FR  RD  RD  SH  SE  SE
  SE  GR  GR  SH  CT  SH  SH  SH  SH  SH  SE  SE  SE  SE  SE  GR  GR  SH  GR  GR  GR  GR  RD  RD  RD 1HQ  GR  GR  FR  SE
  SE  SE  FR  SE  SE  SH 3FC  SH  GR  SE  SE  RF  SE  SE  SE  SE  FR  SE  SH  CT  RD  FR  RD  GR  GR  GR  CT  GR  SE  SE
  SE  SE  SE  SE  RF  SE  SE  SE  SE  SE  SE  SE  SE  SE  RF  SE  SE  SE  SE  SE  SH  SH  SH  CT  GR  MT  SE  SE  SE  SE
