  GR  CT  GR  FR  GR 0FC  RD  MT  CT  RV  GR  GR  FR  GR  GR  RD  GR  GR  CT  GR  GR  GR  AP  FR  GR
  FR  GR  GR  GR  RD  RD  RD  GR  GR  SH  GR  CT  RD  GR  GR  CT  RD  RD  GR  FR  GR  GR  GR  GR  CT
  AP  GR  GR  CT  RD  GR  CT  GR  FR  SH  GR  MT  RD  GR  GR  GR  FR  RD  GR14FC  GR  MT  GR  GR  GR
  GR  GR  MT  GR  GR  FR  GR  GR  SH  SH  GR  GR  RD  BK  GR  GR  CT  RD  RD  GR  GR  GR  CT  GR  FR
  GR  GR  GR  GR  GR  TW  GR  GR  RV  CT  GR  GR  GR  RD  GR  GR  MT  MT  RD  RD  GR  GR  RD  RD  GR
  GR  FR 0FC  GR  RD  RD  RD  CT  BR  GR  FR  GR  CT  RD  GR  GR  GR  MT  MT  RD  TW  FR  GR  RD14FC
  CT  GR  GR  RD  RD  MT  RV  BR  SE  GR  RD  GR  GR  FR  GR  CT  GR  GR  RV  RD  GR  GR  CT  RD  RD
  GR  RD  RD  RD  MT  MT  GR  FR 0HQ  GR  RD  RD  GR  GR  GR  RD  GR  FR  BR  CT  GR  GR  GR  GR  MT
  GR  RD  FR  CT  MT  GR  GR  GR  RD  GR  MT  CT  RD  GR  GR  RD  RD14HQ  SE  BR  RV  SH  FR  GR  CT
  RD  CT  GR  GR  GR  GR  CT  RD  RD  GR  GR  GR  RD  RD  CT  GR  GR  GR  GR  GR  CT  SH  SH  SH  RV
  GR  GR  GR  GR  GR  GR  GR  GR  GR  CT  FR  GR  SH  SH  FR  GR  MT  RD  RD  FR  GR  GR  GR  GR  GR
  GR  GR  GR  BK  RD  RD  FR  GR  GR  RD  SH  SH  SE  SH  GR  GR  CT  RD  GR  GR  GR  GR  MT  CT  GR
  FR  RD  RD  RD  GR  CT  GR  GR  RD  RD  SH  SE  RF  SE  SH  RD  RD  GR  GR  CT  GR  RD  RD  RD  FR
  GR  CT  MT  GR  GR  GR  GR  RD  CT  GR  GR  SH  SE  SH  SH  RD  GR  GR  FR  RD  RD  BK  GR  GR  GR
  GR  GR  GR  GR  GR  FR  RD  RD  MT  GR  FR  SH  SH  GR  FR  CT  GR  GR  GR  GR  GR  GR  GR  GR  GR
  RV  SH  SH  SH  CT  GR  GR  GR  GR  GR  CT  RD  RD  GR  GR  GR  RD  RD  CT  GR  GR  GR  GR  CT  RD
  CT  GR  FR  SH  RV  BR  SE13HQ  RD  RD  GR  GR  RD  CT  MT  GR  RD  GR  GR  GR  MT  CT  FR  RD  GR
  MT  GR  GR  GR  GR  CT  BR  FR  GR  RD  GR  GR  GR  RD  RD  GR11HQ  FR  GR  MT  MT  RD  RD  RD  GR
  RD  RD  CT  GR  GR  RD  RV  GR  GR  CT  GR  FR  GR  GR  RD  GR  SE  BR  RV  MT  RD  RD  GR  GR  CT
13FC  RD  GR  FR  TW  RD  MT  MT  GR  GR  GR  RD  CT  GR  FR  GR  BR  CT  RD  RD  RD  GR11FC  FR  GR
  GR  RD  RD  GR  GR  RD  RD  MT  MT  GR  GR  RD  GR  GR  GR  CT  RV  GR  GR  TW  GR  GR  GR  GR  GR
  FR  GR  CT  GR  GR  GR  RD  RD  CT  GR  GR  BK  RD  GR  GR  SH  SH  GR  GR  FR  GR  GR  MT  GR  GR
  GR  GR  GR  MT  GR13FC  GR  RD  FR  GR  GR  GR  RD  MT  GR  SH  FR  GR  CT  GR  RD  CT  GR  GR  AP
  CT  GR  GR  GR  GR  FR  GR  RD  RD  CT  GR  GR  RD  CT  GR  SH  GR  GR  RD  RD  RD  GR  GR  GR  FR
  GR  FR  AP  GR  GR  GR  CT  GR  GR  RD  GR  GR  FR  GR  GR  RV  CT  MT  RD11FC  GR  FR  GR  CT  GR

13, INFANTRY, 0, 19
14, INFANTRY, 24, 5