  RD  RD 7FC  GR  GR  FR  BR  GR  CT  GR  GR  GR  GR  FR  MT  MT  MT  BK  GR  RD
  GR  GR  RD  GR  CT  BR  AP  GR  GR  GR 7FC  RD  RD  GR  GR  MT  GR  FR  GR  RD
  BK  FR  RD  GR  GR  GR  GR  SH  SH  GR  FR  GR  RD  CT  GR  GR  CT  RD  RD 9FC
  MT  GR  CT  GR  GR  GR  GR  FR  MT  GR  GR  CT  RD  RD  GR  GR  GR  GR  GR  GR
  MT  MT  GR  GR  GR  CT  RD  RD 7HQ  MT  GR  GR  GR  RD  FR  GR  GR  GR  CT  GR
  MT  GR  GR  GR  FR  RD  RD  GR  GR  GR  CT  GR  GR  RD  RD  CT  GR  GR  BR  FR
  FR  GR  CT  RD  RD  RD  CT  GR  GR  GR  RD  GR  GR  CT  RD  RD  GR  GR  AP  BR
  GR  RD  RD  RD  GR  GR  GR  GR  FR  RD  RD  MT  GR  GR  GR  RD  FR  SH  GR  GR
  GR  RD  GR  CT  GR  GR  GR  MT  GR  GR  CT  GR  FR  GR  GR 9HQ  MT  SH  GR  CT
  GR11FC  FR  GR  GR  CT  RD  RD  CT  SH  SH  GR  RD  GR  GR  MT  GR  GR  GR  GR
  GR  GR  GR  GR  MT  GR  GR  RD  GR  SH  SH  CT  RD  RD  CT  GR  GR  FR 9FC  GR
  CT  GR  SH  MT11HQ  GR  GR  FR  GR  CT  GR  GR  MT  GR  GR  GR  CT  GR  RD  GR
  GR  GR  SH  FR  RD  GR  GR  GR  MT  RD  RD  FR  GR  GR  GR  GR  RD  RD  RD  GR
  BR  AP  GR  GR  RD  RD  CT  GR  GR  RD  GR  GR  GR  CT  RD  RD  RD  CT  GR  FR
  FR  BR  GR  GR  CT  RD  RD  GR  GR  CT  GR  GR  GR  RD  RD  FR  GR  GR  GR  MT
  GR  CT  GR  GR  GR  FR  RD  GR  GR  GR  MT 8HQ  RD  RD  CT  GR  GR  GR  MT  MT
  GR  GR  GR  GR  GR  GR  RD  RD  CT  GR  GR  MT  FR  GR  GR  GR  GR  CT  GR  MT
11FC  RD  RD  CT  GR  GR  CT  RD  GR  FR  GR  SH  SH  GR  GR  GR  GR  RD  FR  BK
  RD  GR  FR  GR  MT  GR  GR  RD  RD 8FC  GR  GR  GR  AP  BR  CT  GR  RD  GR  GR
  RD  GR  BK  MT  MT  MT  FR  GR  GR  GR  GR  CT  GR  BR  FR  GR  GR 8FC  RD  RD

9,INFANTRY,18,10
11,INFANTRY,1,9