  CT  MT  CT  MT  RD  FR  GR  CT  GR  GR  GR  CT  RD  GR  GR  GR  FR  CT  GR  MT  MT  CT
  MT  MT  RD  RD  RD  GR  GR  GR  GR  GR  MT  RD  RD  GR  CT  GR  GR  RD  RD  AP  MT  MT
  MT  AP  RD  GR  GR  GR  CT  RD  RD 0FC  RD  FR  GR  MT  GR  GR  GR  GR  GR  RD  RD  CT
  GR  RD  GR  FR 0FC  MT  RD  RD  GR  GR  GR  GR  BK  GR  FR  GR  CT  GR  FR  GR  RD  MT
  CT  RD  GR  GR  RD  RD  GR  FR  GR  GR  CT  RD  GR  GR  GR  GR  RD  RD 3FC  GR  RD  RD
  FR  GR  GR  CT  RD  GR  GR 0HQ  GR  GR  GR  RD  RD  GR  CT  GR  GR  RD  MT  GR  GR  FR
  GR  GR  GR  GR  GR  GR  RD  RD  GR  GR  GR  GR  RD  FR  RD  RD  GR  GR  RD  CT  GR  GR
  GR  CT  GR  FR  GR  CT  RD  GR  GR  CT  FR  GR  MT  GR  GR  RD 3HQ  FR  RD  RD  GR  CT
  GR  GR  MT  GR  GR  GR  FR  GR  GR  RD  GR  CT  RD  GR  GR  GR  GR  GR  GR  RD  GR  GR
  RD  RD  GR  BK  GR  RD  RD  MT  RD  RD  GR  GR  RD  RD  CT  GR  GR  GR  GR 3FC  GR  GR
  CT  RD  FR  GR  RD  RD  GR  GR  CT  GR  RV  RV  GR  GR  FR  GR  GR  CT  GR  RD  MT  GR
  GR  MT  RD  GR  CT  GR  GR  FR  GR  GR  RV  RV  GR  CT  GR  GR  RD  RD  GR  FR  RD  CT
  GR  GR 2FC  GR  GR  GR  GR  CT  RD  RD  GR  GR  RD  RD  MT  RD  RD  GR  BK  GR  RD  RD
  GR  GR  RD  GR  GR  GR  GR  GR  GR  RD  CT  GR  RD  GR  GR  FR  GR  GR  GR  MT  GR  GR
  CT  GR  RD  RD  FR 2HQ  RD  GR  GR  MT  GR  FR  CT  GR  GR  RD  CT  GR  FR  GR  CT  GR
  GR  GR  CT  RD  GR  GR  RD  RD  FR  RD  GR  GR  GR  GR  RD  RD  GR  GR  GR  GR  GR  GR
  FR  GR  GR  MT  RD  GR  GR  CT  GR  RD  RD  GR  GR  GR 1HQ  GR  GR  RD  CT  GR  GR  FR
  RD  RD  GR 2FC  RD  RD  GR  GR  GR  GR  RD  CT  GR  GR  FR  GR  RD  RD  GR  GR  RD  CT
  MT  RD  GR  FR  GR  CT  GR  FR  GR  BK  GR  GR  GR  GR  RD  RD  MT 1FC  FR  GR  RD  GR
  CT  RD  RD  GR  GR  GR  GR  GR  MT  GR  FR  RD 1FC  RD  RD  CT  GR  GR  GR  RD  AP  MT
  MT  MT  AP  RD  RD  GR  GR  CT  GR  RD  RD  MT  GR  GR  GR  GR  GR  RD  RD  RD  MT  MT
  CT  MT  MT  GR  CT  FR  GR  GR  GR  RD  CT  GR  GR  GR  CT  GR  FR  RD  MT  CT  MT  CT

2,INFANTRY,3,17
3,INFANTRY,18,4