  MT  MT  MT  MT 0FC  RD  MT  MT  CT  MT  MT  CT  FR  SH  CT  MT  CT  MT
  CT  MT  CT  GR  GR  RD  CT  MT  MT  MT  FR  GR  GR  SH  SH  FR  MT  MT
  MT  FR  GR  FR  GR  RD  RD  MT  MT  FR  CT  GR 2FC  FR  GR  GR  CT  MT
  CT  SH  GR  CT  MT  FR  RD  CT  MT  GR  GR  GR  GR  GR  CT  FR  GR  MT
  SH  SH  FR  GR  MT  MT  MT  RD  GR  CT  FR  GR  CT  MT  MT  GR  GR 2FC
  FR  GR 0FC  GR  CT  MT 0HQ  RD  SH  RD  CT  GR  MT  MT  FR  RD  RD  RD
  CT  GR  GR  GR  GR  GR  FR  RD  RD  RD  GR  FR 2HQ  MT  RD  RD  CT  MT
  MT  FR  CT  GR  FR  CT  GR  GR  FR  CT  GR  RD  RD  RD  CT  MT  MT  MT
  MT  MT  FR  GR  CT  RD  RD  CT  SH  SH  FR  RD  SH  GR  MT  MT  MT  CT
  CT  MT  MT  MT  GR  SH  RD  FR  SH  SH  CT  RD  RD  CT  GR  FR  MT  MT
  MT  MT  MT  CT  RD  RD  RD  GR  CT  FR  GR  GR  CT  FR  GR  CT  FR  MT
  MT  CT  RD  RD  MT 3HQ  FR  GR  RD  RD  RD  FR  GR  GR  GR  GR  GR  CT
  RD  RD  RD  FR  MT  MT  GR  CT  RD  SH  RD 1HQ  MT  CT  GR 1FC  GR  FR
 3FC  GR  GR  MT  MT  CT  GR  FR  CT  GR  RD  MT  MT  MT  GR  FR  SH  SH
  MT  GR  FR  CT  GR  GR  GR  GR  GR  MT  CT  RD  FR  MT  CT  GR  SH  CT
  MT  CT  GR  GR  FR 3FC  GR  CT  FR  MT  MT  RD  RD  GR  FR  GR  FR  MT
  MT  MT  FR  SH  SH  GR  GR  FR  MT  MT  MT  CT  RD  GR  GR  CT  MT  CT
  MT  CT  MT  CT  SH  FR  CT  MT  MT  CT  MT  MT  RD 1FC  MT  MT  MT  MT
