  FR  GR  MT  RV  GR  SE  SE  MT  RD  GR  CT  GR  BK  GR  GR  GR  FR  GR  CT  GR  BR  FR  FR
  GR  GR  CT  BR  FR  SE  SE  GR  RD  FR  RD  RD  RD  CT  RD  RD  RD  GR  FR  FC  SE  SE  GR
  MT  FR  SE  SE  CT  SH  SH  GR  CT  GR  GR  GR  FR  GR  GR  FR  CT  GR  MT  GR  MT  BR 6FC
  AP  GR  SE  SE  GR  SH  SH  FR  GR  GR  MT  MT  GR  GR  SE  SE  RV  SH  SH  SH  RV  RV  GR
  GR  RD  RD  BR  GR  SE  SE  BR  FR  GR  GR  GR  GR  BK  SE  SE  FR  FR  CT  GR  GR  CT  GR
  FR  RD  SE  SE 6FC  SE  SE  BR  SE  SE  CT  GR  MT  GR  RV  GR  FR  GR  GR  GR  FR  RD  FR
  GR  RD  SE  SH  GR  SH  SE  GR  SE  SE  GR  SH  RV  SH  SH  CT  GR  MT  FR  GR  GR  RD  MT
  CT  RD  FR  GR  MT  FR  GR  GR 6HQ  SE  RV  SH  CT  FR  GR  GR  GR  GR  GR  GR  CT  RD  GR
  GR  CT  GR  MT  MT  GR  CT  GR  RV  RV  CT  GR  GR  GR  GR  FR  RD  CT  FR  MT  GR  GR  FR
  FR  GR  GR  GR  GR  MT  RD  GR  MT  RD  RD  FR  RD  RD  MT  GR  RD  MT  GR  GR  GR  GR  FR
  FR  GR  GR  MT  FR  CT  RD  FR  GR  GR  GR  GR  CT  RV  RV  GR  CT  GR  MT  MT  GR  CT  GR
  GR  RD  CT  GR  GR  GR  GR  GR  GR  FR  CT  SH  RV  SE11HQ  GR  GR  FR  MT  GR  FR  RD  CT
  MT  RD  GR  GR  FR  MT  GR  CT  SH  SH  RV  SH  GR  SE  SE  GR  SE  SH  GR  SH  SE  RD  GR
  FR  RD  FR  GR  GR  GR  FR  GR  RV  GR  MT  GR  CT  SE  SE  BR  SE  SE11FC  SE  SE  RD  FR
  GR  CT  GR  GR  CT  FR  FR  SE  SE  BK  GR  GR  GR  GR  FR  BR  SE  SE  GR  BR  RD  RD  GR
  GR  RV  RV  SH  SH  SH  RV  SE  SE  GR  GR  MT  MT  GR  GR  FR  SH  SH  GR  SE  SE  GR  AP
11FC  BR  MT  GR  MT  GR  CT  FR  GR  GR  FR  GR  GR  GR  CT  GR  SH  SH  CT  SE  SE  FR  MT
  GR  SE  SE  FC  FR  GR  RD  RD  RD  CT  RD  RD  RD  FR  RD  GR  SE  SE  FR  BR  CT  GR  GR
  FR  FR  BR  GR  CT  GR  FR  GR  GR  GR  BK  GR  CT  GR  RD  MT  SE  SE  GR  RV  MT  GR  FR
team, unit type, x, y
11, INFANTRY, 0, 16