  RF  SE  SE  SE  SE  SE  SE  RF  SE  SH  MT  RD  MT  MT  BK  GR  RD  PI  GR  SE
  SE  SH  RD  FR  MT  SH  SE  SH  SH  GR  GR  AP  GR  GR  GR  CT  RD  PI  BK  RF
  SH  CT  RD  BK  FR  CT  RD  GR  RD  FR  GR  GR  CT  GR  FR  GR  RD  FR  SH  SE
  RD  RD  GR  GR  GR  RD  RD  FC  RD  GR  RD  FR  GR  GR  GR  RD  RD12FC  SH  SE
  RD  GR12FC  GR  RD  MT  RD  RD  GR  BK  RD  RD  GR  FR  RD  RD  CT  GR  GR  SH
  MT  GR  RD  FR  RD  SH  SH  RD  CT  GR  GR  RD  CT  GR  RD  GR  GR  GR  CT  GR
  MT  FR  RD  CT  RD  SH  SH  RD  GR  FR  MT  GR  GR  GR12HQ  MT  MT  BK  RD  RD
  FR  GR  RD  GR  BK  BK  BK  BK  GR  FR  MT  GR  RD  GR  RD  RD  GR  GR  FR  MT
  GR  RD  RD  GR  GR  MT  CT  GR  FR  GR  GR  CT  RD  FR  GR  RD  CT  GR  GR  FR
  CT  RD  RD  BK  GR  FR  GR  MT  GR  SH  SH  GR  RD  FR  GR  CT  RD  MT  GR  GR
  GR  GR  MT  RD  CT  GR  FR  RD  GR  SH  SH  GR  MT  GR  FR  GR  BK  RD  RD  CT
  FR  GR  GR  CT  RD  GR  FR  RD  CT  GR  GR  FR  GR  CT  MT  GR  GR  RD  RD  GR
  MT  FR  GR  GR  RD  RD  GR  RD  GR  MT  FR  GR  BK  BK  BK  BK  GR  RD  GR  FR
  RD  RD  BK  MT  MT11HQ  GR  GR  GR  MT  FR  GR  RD  SH  SH  RD  CT  RD  FR  MT
  GR  CT  GR  GR  GR  RD  GR  CT  RD  GR  GR  CT  RD  SH  SH  RD  FR  RD  GR  MT
  SH  GR  GR  CT  RD  RD  FR  GR  RD  RD  BK  GR  RD  RD  MT  RD  GR11FC  GR  RD
  SE  SH11FC  RD  RD  GR  GR  GR  FR  RD  GR  RD  FC  RD  RD  GR  GR  GR  RD  RD
  SE  SH  FR  RD  GR  FR  GR  CT  GR  GR  FR  RD  GR  RD  CT  FR  GR  RD  CT  SH
  RF  BK  PI  RD  CT  GR  GR  GR  AP  GR  GR  SH  SH  SE  SH  MT  FR  RD  SH  SE
  SE  GR  PI  RD  GR  BK  MT  MT  RD  MT  SH  SE  RF  SE  SE  SE  SE  SE  SE  RF
team, unit type, x, y (author: Bamboozle)
12, infantry, 2, 4
