  MT  MT  FR  MT  GR  SH  SH  FR  AP  GR  MT  MT  MT  FR  GR  FR  SE  RF  SE  SE  SE  SE  SE
  FR  GR  GR  CT  GR  SH  SH  PI  PI  CT  GR  FR  GR  CT  GR  SH  SH  SH  SE  SH  TW  GR  SE
  GR  MT  MT  GR  PI  FR  SH  SH  PI  GR  PI  GR  GR  SH  SH  SH  CT  FR  SE  SE  SE  SE  SE
  FR 0FC  GR  GR  PI  GR  SH  SH  BK  GR  GR  FR  GR  SE  SE  GR  MT  GR  GR  FR  GR  CT  SE
  MT  RD  GR  GR  FR  SH  SE 0HQ  GR  MT  FR  GR  CT  RD  GR  FR  GR  BK  CT  GR  SH  SH  SE
  RD  RD  CT  SH  SH  SE  SE  MT  FR  GR  GR  GR  FR  RD  RD  GR  RD  RD  RD  SE  SH  SH  FR
  RD  FR  SH  SE  GR  GR  SH  SH  CT  RD  RD  CT  SH  SH  GR  GR  MT  FR  GR  SE  GR 1FC  MT
  CT  GR  SE  GR  GR  FR  GR  SH  SH  GR  BK  FR  SH  SE  SE  SH  MT  MT  GR  SE  SH  FR  CT
  GR  SH  SH  MT  GR  GR  SP  SE  SE  FR  RD  RD  GR  SE  RF  SH  GR  MT  FR  GR  SE  GR  GR
  FR  SH  SH  GR  FC  GR  FR  SE  SE  SH  GR  RD  GR  SH  SE  SE  FR  GR  FC  GR  SH  SH  FR
  GR  GR  SE  GR  FR  MT  GR  SH  RF  SE  GR  RD  RD  FR  SE  SE  SP  GR  GR  MT  SH  SH  GR
  CT  FR  SH  SE  GR  MT  MT  SH  SE  SE  SH  FR  BK  GR  SH  SH  GR  FR  GR  GR  SE  GR  CT
  MT 0FC  GR  SE  GR  FR  MT  GR  GR  SH  SH  CT  RD  RD  CT  SH  SH  GR  GR  SE  SH  FR  RD
  FR  SH  SH  SE  RD  RD  RD  GR  RD  RD  FR  GR  GR  GR  FR  MT  SE  SE  SH  SH  CT  RD  RD
  SE  SH  SH  GR  CT  BK  GR  FR  GR  RD  CT  GR  FR  MT  GR 1HQ  SE  SH  FR  GR  GR  RD  MT
  SE  CT  GR  FR  GR  GR  MT  GR  SE  SE  GR  FR  GR  GR  BK  SH  SH  GR  PI  GR  GR 1FC  FR
  SE  SE  SE  SE  SE  FR  CT  SH  SH  SH  GR  GR  PI  GR  PI  SH  SH  FR  PI  GR  MT  MT  GR
  SE  GR  TW  SH  SE  SH  SH  SH  GR  CT  GR  FR  GR  CT  PI  PI  SH  SH  GR  CT  GR  GR  FR
  SE  SE  SE  SE  SE  RF  SE  FR  GR  FR  MT  MT  MT  GR  AP  FR  SH  SH  GR  MT  FR  MT  MT
team, unit type, x, y
1, Infantry, 21, 6

