  SH  SH  MT  GR  FR  CT  GR  GR  FR  GR  GR  AP  SE  SE  SE  SH  SH  SH  SH  SH  SH  SH  SH  SH  SH  SH
  MT  MT 1FC  RD  RD  RD  RD  GR  GR  CT  MT  FR  FR  SH  SH  FC  MT  GR  FR  GR  GR  FR  GR  FR  GR  CT
  CT  GR  GR  GR  FR  GR  CT  FR  GR  GR  MT  MT 1HQ  GR  FR  GR  GR  MT  GR  CT  RD  RD 1FC  RD  GR  GR
  GR  GR  FR  CT  GR  MT  GR  GR  GR  MT  GR  FR  GR  SH  SH  GR  CT  GR  GR  GR  MT  GR  GR  RD  RD  FR
  GR  MT  SE  SE  SH  SH  SE  GR  FR  GR  FR  GR  GR  GR  MT  GR  GR  GR  FR  GR  GR  SP  GR  MT  RD  CT
  FR  CT  MT  SE  SE  SH  SE  SE  SH  GR  GR  GR  CT  GR  GR  FR  MT  GR  SE  SE  SH  SE  SH  SH  RD  MT
  GR  RD  FR  SH  SH  GR  SE  SE  SE  SE  GR  MT  FR  GR  TW  GR  SE  SE  SE  SE  SE  SE  SE  SE  RD  MT
  GR  RD  SH  SE  SH  AP  GR  BR  BR  BR  BR  GR  GR  GR  GR  FR  BR  BR  BR  GR  SE  RF  SE  CT  RD  MT
  CT  RD  SH  SH  GR  MT  FR  SE  SE  SE  SH  FR  MT  MT  GR  CT  SE  SE  SE  SP  SE  SE  SE  SH  RD  FR
  FR  RD  SH  SE  SE  SE  SP  SE  SE  SE  CT  GR  MT  MT  FR  SH  SE  SE  SE  FR  MT  GR  SH  SH  RD  CT
  MT  RD  CT  SE  RF  SE  GR  BR  BR  BR  FR  GR  GR  GR  GR  BR  BR  BR  BR  GR  AP  SH  SE  SH  RD  GR
  MT  RD  SE  SE  SE  SE  SE  SE  SE  SE  GR  TW  GR  FR  MT  GR  SE  SE  SE  SE  GR  SH  SH  FR  RD  GR
  MT  RD  SH  SH  SE  SH  SE  SE  GR  MT  FR  GR  GR  CT  GR  GR  GR  SH  SE  SE  SH  SE  SE  MT  CT  FR
  CT  RD  MT  GR  SP  GR  GR  FR  GR  GR  GR  MT  GR  GR  GR  FR  GR  FR  GR  SE  SH  SH  SE  SE  MT  GR
  FR  RD  RD  GR  GR  MT  GR  GR  GR  CT  GR  SH  SH  GR  FR  GR  MT  GR  GR  GR  MT  GR  CT  FR  GR  GR
  GR  GR  RD 0FC  RD  RD  CT  GR  MT  GR  GR  FR  GR 0HQ  MT  MT  GR  GR  FR  CT  GR  FR  GR  GR  GR  CT
  CT  GR  FR  GR  FR  GR  GR  FR  GR  MT  FC  SH  SH  FR  FR  MT  CT  GR  GR  RD  RD  RD  RD 0FC  MT  MT
  SH  SH  SH  SH  SH  SH  SH  SH  SH  SH  SH  SE  SE  SE  AP  GR  GR  FR  GR  GR  CT  FR  GR  MT  SH  SH
team, unit type, x, y
1, INFANTRY, 2, 1