  CT  FR  GR  RV  GR  GR  CT  FR  MT  MT  FR  RV  RV  MT  CT  BR  SE  SR
  GR  GR  CT  BR  FR  GR  GR  GR 0FC  GR  GR  RV  FC  GR  GR  SH  RF  SE
  FR  RV  BR  RV  CT  GR  FR  GR  FR  GR 0HQ  BR  FR  GR  FR  GR  SH  BR
  BR  RV  GR  GR  GR  SH  SE  SE  RV  BR  RV  RV  GR  GR  MT  FR  GR  CT
  RD  CT  FR  MT  SH  SH  SH  SE  SP  RD  CT  GR  GR  FR  GR  GR  GR  MT
  RD  GR  MT  MT  FR  CT  GR  FR  RD  RD  FR  GR  FR  GR  GR  FR  FC  RV
  FC  GR  GR  GR  GR  RD  RD  RD  RD  GR  GR  CT  GR  GR  RV  BR  RV  RV
  FR  GR  CT  RD  GR  FR  GR  CT  FR  FR  GR  GR  FR  CT  RV 1HQ  GR  FR
  GR  GR  FR  RD  GR  GR  GR  MT  MT  MT  FR  GR  RD  RD  BR  GR  GR  MT
  MT 1FC  GR  RD  RD  CT  GR  FR  MT  MT  FR  RD  RD  SP  RV  FR 1FC  MT
  FR  GR  GR  CT  GR  GR  FR  GR  FR  MT  CT  RD  FR  SE  SE  GR  GR  FR
  RV  BR  RV  GR  FR  GR  CT  FR  GR  GR  GR  RD  GR  SH  SE  FR  GR  CT
  MT  RD  SE  SH  SH  MT  GR  GR  CT  GR  FR  RD  CT  SH  SH  GR  GR  GR
  CT  RD  RD  FR  SH  SH  FR  GR  RD  GR  GR  GR  FR  SH  GR  CT  FR  GR
  GR  FR  RD  RD  FR  SH  GR  CT  RD  RD  RD  GR  MT  MT  GR  RV  BR  RV
  TW  MT  GR  RD  RD  SE  RV  GR  GR  FR  CT  GR  MT  FR  GR  BR  CT  GR
  PI  PI  MT  FR  RD  RD  BR  GR 0FC  GR  GR  GR  GR  CT  RV  RV  GR  FR
  SR  PI  TW  GR  CT  MT  RV  FR  MT  GR  FR  FC  RD  RD  BR  FR  GR  CT
team, unit type, x, y
1, INFANTRY, 01, 09