  CT  FR  GR  SP  SH  SH  AP  SE  SE  MT  FR 7FC  GR  TW  RD  FR  RV  CT  GR  GR  FR  GR  CT
  GR  GR  CT  SE  SE  SE  SH  SH  GR  FR  GR  GR  FR  RD  RD  GR  RV  RV  GR  RV  PI  FR  GR
  SH  BR  BR  SE  SH  SH  FR  GR  CT  RD 7HQ  GR  MT  RD  FR  GR  GR  GR  GR  GR  PI  FR  MT
  SH  CT  FR  GR  GR  FR  GR  MT  GR  RD  RD  FR  CT  RD  GR  FR 7FC  FR  RD  RD  ME  CT  GR
  GR  FR  GR  GR  MT  GR  GR  MT  GR  GR  RD  RD  RD  RD  GR  MT  GR  FR  RD  GR  PI  GR  GR
  GR  GR  GR  GR  MT  CT  GR  GR  MT  FR  GR  GR  GR  FR  GR  GR  PI  GR  CT  GR  RV  RV  GR
  FR  GR  CT  GR  GR  MT  GR  BK  MT  GR  CT  FR  GR  MT  FR  GR  RV  GR  RD  FR  GR  RV  BR
  FR  GR  RD  FR  FR  GR  GR  GR  GR  SH  SH  SH  GR  SE  CT  GR  PI  FR  RD  RD  RD  GR  CT
  CT  GR  RD  RD  RD  FR  PI  GR  CT  SE  GR  SH  SH  SH  GR  GR  GR  GR  FR  FR  RD  GR  FR
  BR  RV  GR  FR  RD  GR  RV  GR  FR  MT  GR  FR  CT  GR  MT  BK  GR  MT  GR  GR  CT  GR  FR
  GR  RV  RV  GR  CT  GR  PI  GR  GR  FR  GR  GR  GR  FR  MT  GR  GR  CT  MT  GR  GR  GR  GR
  GR  GR  PI  GR  RD  FR  GR  MT  GR  RD  RD  RD  RD  GR  GR  MT  GR  GR  MT  GR  GR  FR  GR
  GR  CT  ME  RD  RD  FR12FC  FR  GR  RD  CT  FR  RD  RD  GR  MT  GR  FR  GR  GR  FR  CT  SH
  MT  FR  PI  GR  GR  GR  GR  GR  FR  RD  MT  GR12HQ  RD  CT  GR  FR  SH  SH  SE  BR  BR  SH
  GR  FR  PI  RV  GR  RV  RV  GR  RD  RD  FR  GR  GR  FR  GR  SH  SH  SE  SE  SE  CT  GR  GR
  CT  GR  FR  GR  GR  CT  RV  FR  RD  TW  GR12FC  FR  MT  SE  SE  AP  SH  SH  SP  GR  FR  CT
team, unit type, x, y
12, INFANTRY, 11, 15