  GR  FR  RD  RD  CT  RD  GR  FR  SH  SH  GR  AP  RD  RD  RD  CT  RD  FR  GR  CT  FR
  RD  RD13FC  FR  GR  RD  GR  GR  SH  SH  SE  GR  FR  FR  GR  GR  RD  MT  GR  RD  RD
  CT  FR  GR  MT  RD  RD  SH  SH  SE  CT  SH  SH  GR  GR  SE  SE  RD  RD  FR  GR  RD
  RD  GR  RD  RD  CT  SH  SH  SE  FR  GR  SE  SE  SH  SH  SH  GR  FR  RD  TW  RD  RD
  RD  RD  RD  SE  SH  SH  RD  RD  FR  GR13HQ  SE  SH  SH  SH  GR  CT  MT  GR  GR  FR
  GR  SE  SE  SE  SH  RD  RD  FC  FR  RD  RD  GR  GR  CT  SH  SH  GR  GR  SE  GR  CT
  SP  SH  SH  GR  FR  RD  RD  GR  RD  RD  FR  SE  SH  SH  SE  SE  GR  SE  SE  SE  GR
  GR  SE  SE  SE  GR  CT  RD  RD  RD  GR  SH  SE  SE  SH  SH  SE  SH  SE  SE  SP  GR
  GR  GR  SE  SE  SE  GR  SE  SH  SH  SH  SH  SE  SE  CT  GR  SH  SH  GR  GR  FR  GR
  GR  AP  GR  SH  SH  SH  SE  SH  SE  SE  GR  SH  SH  GR  GR  SH  SE  SE  GR 8FC  GR
  SH  GR  FR  GR  GR  SH  SE  GR  SH  SH  CT  SE  SH  FR  GR  SH  SH  CT  GR  GR  CT
  SH  SE  GR  GR  CT  SH  SH  FR  SH  SE  FR  SH  SE  GR  SE  SE  SE  SE  SH  GR  FR
  GR  SH  SH  SE  SH  SH  FR  CT  SH  SH  GR  SH  SH  CT  FR  SH  SH  SE  SH  SH  GR
  FR  GR  SH  SE  SE  SE  SE  GR  SE  SH  FR  SE  SH  FR  SH  SH  CT  GR  GR  SE  SH
  CT  GR  GR  CT  SH  SH  GR  FR  SH  SE  CT  SH  SH  GR  SE  SH  GR  GR  FR  GR  SH
  GR13FC  GR  SE  SE  SH  GR  GR  SH  SH  GR  SE  SE  SH  SE  SH  SH  SH  GR  AP  GR
  GR  FR  GR  GR  SH  SH  GR  CT  SE  SE  SH  SH  SH  SH  SE  GR  SE  SE  SE  GR  GR
  GR  SP  SE  SE  SH  SE  SH  SH  SE  SE  SH  GR  RD  RD  RD  CT  GR  SE  SE  SE  GR
  GR  SE  SE  SE  GR  SE  SE  SH  SH  SE  FR  RD  RD  GR  RD  RD  FR  GR  SH  SH  SP
  CT  GR  SE  GR  GR  SH  SH  CT  GR  GR  RD  RD  FR  FC  RD  RD  SH  SE  SE  SE  GR
  FR  GR  GR  MT  CT  GR  SH  SH  SH  SE 8HQ  GR  FR  RD  RD  SH  SH  SE  RD  RD  RD
  RD  RD  TW  RD  FR  GR  SH  SH  SH  SE  SE  GR  FR  SE  SH  SH  CT  RD  RD  GR  RD
  RD  GR  FR  RD  RD  SE  SE  GR  GR  SH  SH  CT  SE  SH  SH  RD  RD  MT  GR  FR  CT
  RD  RD  GR  MT  RD  GR  GR  FR  FR  GR  SE  SH  SH  GR  GR  RD  GR  FR 8FC  RD  RD
  FR  CT  GR  FR  RD  CT  RD  RD  RD  AP  GR  SH  SH  FR  GR  RD  CT  RD  RD  FR  GR
team, unit type, x, y
13, INFANTRY, 2, 1