  GR  FR  RV  MT  RD  FR  GR  GR  CT  GR  GR  FR  GR  MT  RV  MT  GR  CT  GR  FR  RD  GR  GR  CT  MT
  MT  FC  RV  MT  RD  RD  RD  FR  GR  FR  GR  GR  AP  FR  BR 4FC  RD  RD  GR  GR  CT  GR  FR  RD  GR
  FR  GR  RV  RV  FR  GR  RD  FR  MT  GR 4HQ  GR  GR  RV  RV  RD  RD  FR  GR  GR  RD  FR  MT  RD  GR
  CT  GR  MT  RV  GR  GR 4FC  GR  MT  GR  SH  SH  FR  RV  GR  RD  GR  MT  GR  MT  RD  RD  RD  RD  FR
  GR  RD  RD  BR  CT  RD  RD  GR  CT  MT  SH  SH  MT  CT  GR  CT  MT  RD  RD  CT  MT  GR  GR  GR  CT
  FR  RD  GR  RV  FR  GR  RV  RV  RV  MT  CT  RD  FR  GR  GR  FR  MT  RD  MT  GR  GR  MT  FR  RD  RD
  MT  RD  CT  RV  BR  MT  RV  CT  GR  GR  FR  RD  RD  BK  GR  GR  GR  RD  GR  MT  GR  MT  GR  RD  GR
  GR  RD  GR  MT  GR  MT  GR  RD  GR  GR  GR  BK  RD  RD  FR  GR  GR  CT  RV  MT  BR  RV  CT  RD  MT
  RD  RD  FR  MT  GR  GR  MT  RD  MT  FR  GR  GR  FR  RD  CT  MT  RV  RV  RV  GR  FR  RV  GR  RD  FR
  CT  GR  GR  GR  MT  CT  RD  RD  MT  CT  GR  CT  MT  SH  SH  MT  CT  GR  RD  RD  CT  BR  RD  RD  GR
  FR  RD  RD  RD  RD  MT  GR  MT  GR  RD  GR  RV  FR  SH  SH  GR  MT  GR 3FC  GR  GR  RV  MT  GR  CT
  GR  RD  MT  GR  RD  GR  GR  FR  RD  RD  RV  RV  GR  GR 3HQ  GR  MT  FR  RD  GR  FR  RV  RV  GR  FR
  GR  RD  FR  GR  CT  GR  GR  RD  RD 3FC  BR  FR  AP  GR  GR  FR  GR  FR  RD  RD  RD  MT  RV  FC  MT
  MT  CT  GR  GR  RD  FR  GR  CT  GR  MT  RV  MT  GR  FR  GR  GR  CT  GR  GR  FR  RD  MT  RV  FR  GR
team, unit type, x, y
4, INFANTRY, 6, 3