  GR  MT  MT  FR  GR  RD  RD  RD  RD  CT  FR  BK  GR  GR  GR  GR  MT  FR  CT  MT  MT
  MT  BK  GR  CT  GR  RD  GR  MT  RD  RD  BK  BK  BK  RD  AP  RD  GR  MT  MT  GR  MT
  MT  GR  FR  GR  RD  RD  GR  GR  GR  GR  GR  BK  GR  GR  GR  RD  CT  GR  MT  GR  FR
  RV  BR  RV  GR  RD  GR  FR  CT  GR  GR  GR  PI  RV  PI  FR  GR  GR  GR  GR  FR  MT
  FR  GR  RV  FR  MT  GR  SH  SH  GR  FR  CT  GR  GR  PI  PI  RV  PI 1FC  GR  CT  GR
  FR  GR  RV  RV  RV  GR  SH  SH  GR  MT  GR  GR  GR  FR  GR  GR  PI  PI  FR  GR  GR
  GR  GR  GR  GR  BR  GR  MT  GR  CT  GR  BK  GR 1HQ  GR  GR  CT  GR  PI  FR  FR  GR
  GR  CT  RD  RD  RV  FR  TW  GR  FR  GR  GR  FR  GR  MT  GR  FR  GR  PI  PI  GR  CT
  RD  RD  FR  RD  RV  SH  SH  SH  RV  GR  CT  RD  RD  RD  PI  GR  PI  FC  BR  GR  GR
  RD  GR  MT  RD  RD  GR  GR  FR  PI  RD  RD  RD  MT  RD  PI  GR  PI  BR  RV  GR  FR
  CT  FR  GR  GR  RD  GR  CT  PI  PI  RD  FR  MT  GR  RD  RV  BK  GR  GR  GR  FR  GR
  RD  RD  RD  FR  CT  GR  PI  PI  FR  RD  GR  RD  CT  GR  PI  GR  RD  RD  RD 1FC  GR
  GR 6FC  RD  RD  RD  GR  PI  GR  CT  RD  GR  RD  FR  PI  PI  GR  CT  FR  RD  RD  RD
  GR  FR  GR  GR  GR  BK  RV  RD  GR  MT  FR  RD  PI  PI  CT  GR  RD  GR  GR  FR  CT
  FR  GR  RV  BR  PI  GR  PI  RD  MT  RD  RD  RD  PI  FR  GR  GR  RD  RD  MT  GR  RD
  GR  GR  BR  FC  PI  GR  PI  RD  RD  RD  CT  GR  RV  SH  SH  SH  RV  RD  FR  RD  RD
  CT  GR  PI  PI  GR  FR  GR  MT  GR  FR  GR  GR  FR  GR  TW  FR  RV  RD  RD  CT  GR
  GR  FR  FR  PI  GR  CT  GR  GR 6HQ  GR  BK  GR  CT  GR  MT  GR  BR  GR  GR  GR  GR
  GR  GR  FR  PI  PI  GR  GR  FR  GR  GR  GR  MT  GR  SH  SH  GR  RV  RV  RV  GR  FR
  GR  CT  GR 6FC  PI  RV  PI  PI  GR  GR  CT  FR  GR  SH  SH  GR  MT  FR  RV  GR  FR
  MT  FR  GR  GR  GR  GR  FR  PI  RV  PI  GR  GR  GR  CT  FR  GR  RD  GR  RV  BR  RV
  FR  GR  MT  GR  CT  RD  GR  GR  GR  BK  GR  GR  GR  GR  GR  RD  RD  GR  FR  GR  MT
  MT  GR  MT  MT  GR  RD  AP  RD  BK  BK  BK  RD  RD  MT  GR  RD  GR  CT  GR  BK  MT
  MT  MT  CT  FR  MT  GR  GR  GR  GR  BK  FR  CT  RD  RD  RD  RD  GR  FR  MT  MT  GR
team, unit type, x, y (author: mori14)
6, infantry, 1, 12
1, bboat, 6, 13
1, bboat, 8, 20
6, bboat, 12, 3
6, bboat, 14, 10
