  RF  SE  SE  SH  GR  RD11FC  RD  RD  FR  FR  CT  GR  RV  BK  GR  FR  SH  SE  SE  SE  SH  TW  SH  SE  SE
  SE  SH  SH  RV  GR  RD  GR  FR  RD  RD  RD  GR  FR  RV  GR  GR  AP  MT  GR  SH  SE  SE  SH  SE  SE  RF
  SH  GR  GR  BR  GR  CT  GR  GR  GR  MT  RD  GR  GR  BR  GR  GR  MT  MT  MT  FR  SH  SE  SE  SE  SE  SE
  GR  FR  GR  RV  MT  GR  GR  CT  GR  RD  RD  RV  RV  RV  GR  FR  FR  MT  GR  MT  RD  RD  GR  SH  SE  SE
  FR  CT  GR  RV  RV  BR  RV  RV  SH  SP  SH  RV  FR  GR  GR  GR  GR  CT  MT  MT  MT  RD  GR  FR  SH  SE
  FR  GR  GR  GR  CT  GR  FR  GR  GR  FR  GR  GR  GR  FR  RD  RD  GR  GR  GR  MT  FR  AP  GR  GR  SH  SE
  GR  FR  BK  GR  GR  GR  GR  GR  GR  GR  MT  GR  GR  GR  CT  RD  GR11HQ  FR  GR  GR  RD  GR  SE  SE  SE
  SE  GR  GR  FR  GR  MT  MT  GR  FR  GR  GR  GR  GR  GR  FR  RD  GR  GR  GR  GR  RD  RD  SH  SE  SE  SE
  SE  SE  SH  GR  MT  GR  GR  FR  CT  GR  GR  CT  GR  BK  FR  RD  RD  RD  CT  RD  RD  GR  SE  SE  RF  SE
  SE  SE  SE  SH  GR  TW  GR  GR  GR  GR  GR  FR  FR  GR  GR  FR  GR  GR  RD  MT  GR  SH  SE  RF  SE  SE
  SE  RF  SE  SE  FR  GR  GR  GR  MT 6FC  FR  MT  GR  FR  CT  MT  GR  FR  RD  GR  FR  SH  SE  RF  SE  SE
  RF  SE  SE  SE  SH  FR 6FC  RD11CT  MT  MT  GR  GR  GR  GR  MT  MT  CT  RD11FC  FR  SH  SE  SE  SE  RF
  SE  SE  RF  SE  SH  FR  GR  RD  FR  GR  MT  CT  FR  GR  MT  FR11FC  MT  GR  GR  GR  FR  SE  SE  RF  SE
  SE  SE  RF  SE  SH  GR  MT  RD  GR  GR  FR  GR  GR  FR  FR  GR  GR  GR  GR  GR  TW  GR  SH  SE  SE  SE
  SE  RF  SE  SE  GR  RD  RD  CT  RD  RD  RD  FR  BK  GR  CT  GR  GR  CT  FR  GR  GR  MT  GR  SH  SE  SE
  SE  SE  SE  SH  RD  RD  GR  GR  GR  GR  RD  FR  GR  GR  GR  GR  GR  FR  GR  MT  MT  GR  FR  GR  GR  SE
  SE  SE  SE  GR  RD  GR  GR  FR 6HQ  GR  RD  CT  GR  GR  GR  MT  GR  GR  GR  GR  GR  GR  GR  BK  FR  GR
  SE  SH  GR  GR  AP  FR  MT  GR  GR  GR  RD  RD  FR  GR  GR  GR  FR  GR  GR  FR  GR  CT  GR  GR  GR  FR
  SE  SH  FR  GR  RD  MT  MT  MT  CT  GR  GR  GR  GR  FR  RV  SH  SP  SH  RV  RV  BR  RV  RV  GR  CT  FR
  SE  SE  SH  GR  RD  RD  MT  GR  MT  FR  FR  GR  RV  RV  RV  RD  RD  GR  CT  GR  GR  MT  RV  GR  FR  GR
  SE  SE  SE  SE  SE  SH  FR  MT  MT  MT  GR  GR  BR  GR  GR  RD  MT  GR  GR  GR  CT  GR  BR  GR  GR  SH
  RF  SE  SE  SH  SE  SE  SH  GR  MT  AP  GR  GR  RV  FR  GR  RD  RD  RD  FR  GR  RD  GR  RV  SH  SH  SE
  SE  SE  SH  TW  SH  SE  SE  SE  SH  FR  GR  BK  RV  GR  CT  FR  FR  RD  RD 6FC  RD  GR  SH  SE  SE  RF
team, unit type, x, y
11, INFANTRY, 16, 12