  FR  GR  RD  RD  AP  RD  RD  RD  CT  FR  RV  MT  GR  FR  GR  FC  BK  GR  CT  GR  GR
  RD  TW  RD  GR  GR  MT  GR  RD12FC  GR  SH  GR  CT  GR  MT  GR  FR  GR  GR  GR  FR
  RD  FR  GR  GR  MT  MT  GR  GR  GR  RV  SH  FR  GR  GR  GR  MT  GR  GR  FR12FC  GR
  RD  MT  MT  FR  MT  GR  CT  FR  RV  SH  CT  GR  GR  MT  GR  GR  GR  FR  GR  MT  GR
  CT  MT  GR  GR  FR  GR  GR  MT  RV  GR  FR  GR  MT12HQ  FR  GR  CT  MT  GR  GR  FR
  GR  GR  GR  CT  RD  RD  RD  RD  MT  GR  FR  GR  CT  RD  FR  MT  RD  RD  MT  GR  GR
  FR  GR  GR  GR  GR  MT  GR  RD  CT  GR  MT  GR  GR  RD  RD  RD  GR  RD  RD  FR  GR
  GR  MT  GR  GR  GR  MT  FR  GR  BK  GR  ME  GR  GR  GR  MT  CT  FR  GR  RD  RD  CT
  CT  RD  RD  GR  FR  CT  MT  GR  GR  GR  ME  GR  BK  GR  FR  MT  GR  GR  GR  MT  GR
  GR  FR  RD  RD  GR  RD  RD  RD  GR  GR  MT  GR  CT  RD  GR  MT  GR  GR  GR  GR  FR
  GR  GR  MT  RD  RD  MT  FR  RD  CT  GR  FR  GR  MT  RD  RD  RD  RD  CT  GR  GR  GR
  FR  GR  GR  MT  CT  GR  FR 5HQ  MT  GR  FR  GR  RV  MT  GR  GR  FR  GR  GR  MT  CT
  GR  MT  GR  FR  GR  GR  GR  MT  GR  GR  CT  SH  RV  FR  CT  GR  MT  FR  MT  MT  RD
  GR 5FC  FR  GR  GR  MT  GR  GR  GR  FR  SH  RV  GR  GR  GR  MT  MT  GR  GR  FR  RD
  FR  GR  GR  GR  FR  GR  MT  GR  CT  GR  SH  GR 5FC  RD  GR  MT  GR  GR  RD  TW  RD
  GR  GR  CT  GR  BK  FC  GR  FR  GR  MT  RV  FR  CT  RD  RD  RD  AP  RD  RD  GR  FR
team, unit type, x, y
12, INFANTRY, 19, 2