  FR  FR  FR  GR  FR  RD  GR  FR  FR  GR  MT  XX  MT  FR  MT  MT  MT  MT  MT
  GR  FR  GR  CT  CT  RD  GR  GR  FR  GR  CT  XX  GR  GR  FR  GR  GR  GR  FR
  GR  GR  RD  RD  RD  RD  GR  GR  GR  GR  GR  RD  GR  GR  CT  CT  GR  GR  GR
  GR  FR  RD  GR  GR  FC  CT  GR  GR  SE  SE  SE  FR  GR  GR  GR  GR  GR  FR
  GR  FR  RD  GR  GR  GR  GR  FR  SE  SE  SE  SE  GR  FR  GR  GR  CT  CT  GR
  GR  FR  RD  GR  FR  GR  GR  FR  SE  SE  SE  FR  MT  FR  GR  GR  RD  RD  RD
  GR  GR  RD  CT  GR  FR  GR  GR  SE  SE  GR  MT  FR  FR  FR  CT  RD  GR  FR
  GR  CT  RD  FR  GR  GR  GR  CT  RD  RD 1CT  GR  FR  FR  FR  FR  RD  GR  GR
  GR  FR  RD  FR  GR  GR  GR  GR  MT  XX  MT  MT  MT  MT  FR  GR  RD  GR  GR
  GR  FR  RD  FR  GR  GR  GR  MT  MT  XX  MT  MT  GR  GR  GR 1CT  RD 1CT  GR
  GR  GR 0HQ  GR  GR  GR  MT  MT  XX  XX  MT  MT  GR  GR  GR  GR  RD  GR  GR
  FR 0FC  RD 0FC  GR  MT  MT  XX  XX  MT  MT  MT  MT  GR  MT  GR 1HQ  GR  GR
  GR  GR  RD  GR  GR  MT  MT  XX  MT  MT  MT  MT  MT  MT  GR 1FC  GR 1FC  GR
