 0HQ 0CT 0FC  FR  FR  FR  FR  MT  MT  FR  FR  FR  FR 2FC 2CT 2HQ
 0CT 0FC  FR  CT  FR  FR  CT  FR  FR  T4  FR  FR  CT  FR 2FC 2CT
 0FC  FR  FR  FR  RD  RD  RD  RD  RD  RD  RD  RD  FR  FR  FR 2FC
  FR  FR  FR  FR  RD  FR  FR  FR  FR  FR  FR  RD  FR  FR  FR  FR
  FR  FR  FR  T4  RD  FR  FR  FR  FR  FR  FR  RD  CT  FR  FR  FR
  FR  FR  MT  FR  RD  FR  FR  SR  MT  FR  FR  RD  FR  MT  FR  FR
  FR  FR  MT  FR  RD  FR  FR  MT  SR  FR  FR  RD  FR  MT  FR  FR
  FR  FR  FR  CT  RD  FR  FR  FR  FR  FR  FR  RD  T4  FR  FR  FR
  FR  FR  FR  FR  RD  FR  FR  FR  FR  FR  FR  RD  FR  FR  FR  FR
 3FC  FR  FR  FR  RD  RD  RD  RD  RD  RD  RD  RD  FR  FR  FR 1FC
 3CT 3FC  FR  CT  FR  FR  T4  FR  FR  CT  FR  FR  CT  FR 1FC 1CT
 3HQ 3CT 3FC  FR  FR  FR  FR  MT  MT  FR  FR  FR  FR 1FC 1CT 1HQ
team, unit type, x, y (author: IntSys, AW4)
