  SE  SE  SE  SE  SE  SE  SE  SE  SE  SE  SE  SE  SE  SE  SE
  SE 0HQ 0FC  FR  FR  GR  GR  RV  GR  GR  FR  FR 2FC 2HQ  SE
  SE 0FC  GR  GR  GR  GR  FC  BR  FC  GR  GR  GR  GR 2FC  SE
  SE  FR  CT  GR  CT  GR  GR  RV  GR  GR  CT  GR  CT  FR  SE
  SE  FR  GR  GR  GR  FC  FR  BR  FR  FC  GR  GR  GR  FR  SE
  SE  CT  GR  GR  GR  FR  GR  RV  GR  FR  GR  GR  GR  CT  SE
  SE  RV  BR  RV  RV  BR  RV  RV  RV  BR  RV  RV  BR  RV  SE
  SE  CT  GR  GR  GR  FR  GR  RV  GR  FR  GR  GR  GR  CT  SE
  SE  FR  GR  GR  GR  FC  FR  BR  FR  FC  GR  GR  GR  FR  SE
  SE  FR  CT  GR  CT  GR  GR  RV  GR  GR  CT  GR  CT  FR  SE
  SE 3FC  GR  GR  GR  GR  FC  BR  FC  GR  GR  GR  GR 1FC  SE
  SE 3HQ 3FC  FR  FR  GR  GR  RV  GR  GR  FR  FR 1FC 1HQ  SE
  SE  SE  SE  SE  SE  SE  SE  SE  SE  SE  SE  SE  SE  SE  SE
