  SE  SE  SE  SE  SE  SE  SE  SE  SE  SE  SE  SE  SE  SE  SE  SE  SE
  SE  TT  TT  TT  TT  TT  TT  TT  TT  TT  TT  TT  TT  TT  TT  TT  SE
  SE  TT  SE  SE  SE  SE  SE  SE  SE  SE  SE  SE  SE  SE  SE  TT  SE
  SE  TT  SE  SE  SE  SE  SE  SE  SE  SE  SE  SE  SE  SE  SE  TT  SE
  SE  TT  SE  SE  GR  FR  RD  RD  BR  RD  RD  GR  FR 6FC  GR  TT  SE
  SE  TT  SE  GR  GR  FR  RD  FR  RV  GR  RD  CT  GR  GR15HQ15FC  SE
  SE  TT  SE  CT  CT  RD  RD  SE  SE  SE  RD  GR  MT  GR  RD15FC  SE
  SE  TT  SE  GR  GR  RD  GR  SE  SE  SE  RD  CT  MT  CT  RD  GR  SE
  SE  TT  SE14FC  RD  RD  CT  SE  SE  FR  RD  RD  RD  RD  RD  CT  SE
  SE  TT  SE14FC14HQ  GR  GR  GR  GR  FR  FR  GR  SE  SE  BR  SE  SE
  SE  TT  SE  TT  GR10FC  GR  GR  GR  GR  GR  GR  SE  SE  GR  GR  SE
  SE  TT  SE  TT  SE  SE  MT  CT  MT  FR  CT  GR  BR  GR  CT  CT  SE
  SE  TT  SE  TT  SE  SE  SE  SE  SE  SE  SE  SE  SE  SE  SE  SE  SE
  SE  TT  SE  TT  TT  TT  TT  TT  TT  TT  TT  TT  TT  TT  TT  TT  SE
  SE  TT  SE  SE  SE  SE  SE  SE  SE  SE  SE  SE  SE  SE  SE  TT  SE
  SE  TT  SE  SE  SE  SE  SE  SE  SE  SE  SE  SE  SE  SE  SE  TT  SE
  SE  TT  SE  SE  SE  SE  SE  SE  SE  SE  SE  SE  SE  SE  SE  TT  SE
  SE  TT  SE  SE  GR  FR  RD  RD  BR  RD  RD  GR  FR14FC  GR  TT  SE
  SE  TT  SE  GR  GR  FR  RD  FR  RV  GR  RD  CT  GR  GR10HQ10FC  SE
  SE  TT  SE  CT  CT  RD  RD  SE  SE  SE  RD  GR  MT  GR  RD10FC  SE
  SE  TT  SE  GR  GR  RD  GR  SE  SE  SE  RD  CT  MT  CT  RD  GR  SE
  SE  TT  SE 6FC  RD  RD  CT  SE  SE  FR  RD  RD  RD  RD  RD  CT  SE
  SE  TT  SE 6FC 6HQ  GR  GR  GR  GR  FR  FR  GR  SE  SE  BR  SE  SE
  SE  TT  SE  TT  GR15FC  GR  GR  GR  GR  GR  GR  SE  SE  GR  GR  SE
  SE  TT  SE  TT  SE  SE  MT  CT  MT  FR  CT  GR  BR  GR  CT  CT  SE
  SE  TT  TT  TT  SE  SE  SE  SE  SE  SE  SE  SE  SE  SE  SE  SE  SE
  SE  SE  SE  SE  SE  SE  SE  SE  SE  SE  SE  SE  SE  SE  SE  SE  SE
