  MT  MT  MT  MT  MT  MT  MT  MT  CT  RD  RD  FR  SH  SE  SH  CT  AP  SE  SH  GR  CT  BR  BR  RD  RD  CT  FR  MT  MT  MT
  MT  CT  MT  FR  AP  MT  MT  MT  MT  GR  RD  RD  CT  SE  SE  SE  SE  SH  FR  GR  FR  SE  SH  GR  RD  RD  RD  FR  MT  MT
  MT  MT  FR  GR  RD  GR  GR  MT  MT  MT  FR  RD  RD  RD  FR  SH  SE  GR  GR  SH  SE  SE  SE  CT  GR  FR  RD  RD  CT  MT
  MT10FC14CT  RD  RD  CT  FR  GR  GR  GR  MT  SE  GR  RD  RD  CT  SH  FC  SE  SE  SE  RF  SE  SH  SE  SH  GR  GR  GR  MT
  GR  GR  RD  RD  GR  GR  GR  GR  CT  GR  CT  SE  SH  SP  RD  RD  SH  SH  RF  SE  SE  SE  SE  SH  SE  SE  SE14SP  GR  GR
  GR  FR  RD  GR  GR  FR  SH  SH  SH  SE  SH  SE  SE  SE  SH  RD  RD  RD  SH  RF  SE  SH  GR  FR  SE  SE  SE  SH  GR  FR
  CT  RD  RD  CT  MT  SE  SE  RF  SH  SE  SH  SH  SE  SE  SE  SE  BK10FC  RD  SE  SE  SE  SH10LB  GR  GR  SH  SH  GR  CT
  GR  RD  FR  SH  SE  SE  SE  SE  GR10LB  GR  GR  CT  SH  SE  SE  SE  FR  SP  SE  RF  SE  SH  GR  GR  CT  SH  SH  GR  GR
  GR  RD  GR  SE  RF  SE  SH  CT  GR  FR  GR  GR  FR  CT  SE  SE  SE  SE  GR  SE  SE  SE  GR  FR  GR  FR  SH  SH  GR  TW
  GR  CT  GR  SE  SE  SH  MT  RD  FR  GR  CT  SE  SH  SE  SE  RF  SE  SE  SE  SE  SH  GR  RD  RD  CT  SH  SE  MT  GR  GR
  GR  GR  MT  SE  SH  CT  RD  RD  GR  SH  SE  SE  SE  SE  RF  SE  SE  SH  SE  CT  GR  FR  RD  MT  SH  SE  SE  GR  CT  GR
  TW  GR  SH  SH  FR  GR  FR  GR  SE  SE  SE  GR  SE  SE  SE  SE  CT  FR  GR  GR  FR  GR  CT  SH  SE  RF  SE  GR  RD  GR
  GR  GR  SH  SH  CT  GR  GR  SH  SE  RF  SE  SP  FR  SE  SE  SE  SH  CT  GR  GR14LB  GR  SE  SE  SE  SE  SH  FR  RD  GR
  CT  GR  SH  SH  GR  GR14LB  SH  SE  SE  SE  RD14FC  BK  SE  SE  SE  SE  SH  SH  SE  SH  RF  SE  SE  MT  CT  RD  RD  CT
  FR  GR  SH  SE  SE  SE  FR  GR  SH  SE  RF  SH  RD  RD  RD  SH  SE  SE  SE  SH  SE  SH  SH  SH  FR  GR  GR  RD  FR  GR
  GR  GR10SP  SE  SE  SE  SH  SE  SE  SE  SE  RF  SH  SH  RD  RD  SP  SH  SE  CT  GR  CT  GR  GR  GR  GR  RD  RD  GR  GR
  MT  GR  GR  GR  SH  SE  SH  SE  RF  SE  SE  SE  FC  SH  CT  RD  RD  GR  SE  MT  GR  GR  GR  FR  CT  RD  RD  CT14FC  MT
  MT  CT  RD  RD  FR  GR  CT  SE  SE  SE  SH  GR  GR  SE  SH  FR  RD  RD  RD  FR  MT  MT  MT  GR  GR  RD  GR  FR  MT  MT
  MT  MT  FR  RD  RD  RD  GR  SH  SE  FR  GR  FR  SH  SE  SE  SE  SE  CT  RD  RD  GR  MT  MT  MT  MT  AP  FR  MT  CT  MT
  MT  MT  MT  FR  CT  RD  RD  BR  BR  CT  GR  SH  SE  AP  CT  SH  SE  SH  FR  RD  RD  CT  MT  MT  MT  MT  MT  MT  MT  MT
team, unit type, x, y
14, Infantry, 12, 13

