  SE  SE  SE  TW  GR  GR  GR  MT  MT  MT  GR  GR  CT  GR  SE  SE  SE  SH  GR  GR  CT  SH
  SE  SE  SE  RD  RD  RD  MT  MT  GR  MT  MT  GR  GR  GR  AP  SE  SE  SE  SE  TW  SE  SE
  SE  SE  FR  GR  FR  RD  GR  GR  GR  GR  GR  RD  RD  RD  GR  FR  SE  SE  SE  SH  SE  SE
  SE  SP  GR  FR  GR  RD  CT  GR 1FC  GR  CT  RD  FR  RD  RD  FR  FR  SE  SE  SE  SE  SE
  SE  GR  MT  GR  GR  GR  GR  GR  GR  GR  GR  GR  GR  FR  RD  CT  GR  SE  SE  SH  SE  SE
  SE  FR  GR  GR  BK  CT  MT  MT  GR  MT  MT  FR  GR  GR  GR  GR  GR  SH  SP  GR  SE  SE
  SE  GR  CT  GR  GR  FR  RD  MT  MT  MT  LB  RD  GR  GR  FR  GR  RV  SH  GR  SE  SE  SE
  SE  GR  GR  FR  MT  GR  RD  RD  BK  CT  RD  RD 1LB  FR  GR  MT  RV  SH  SH  SE  SE  SE
  SE  FR  GR  GR  FR  GR  CT  RD  RD  RD  RD  FR  GR  MT  RV  RV  RV  MT  GR  GR  SE  SE
  SE  SH  GR  CT  GR  GR  GR  GR  FR  GR  MT  CT  SH  SH  RV  MT  FC  GR  GR  GR  CT  SE
  SE  SE  SH  GR  GR  MT  GR  FR  GR  CT  GR  SH  SH  MT  GR  GR  SH  SH  GR  GR  FR  SE
  SE  SE  SH  GR  GR  GR  CT  GR  GR  FR  SH  SH  GR  MT  MT  GR  SH  SH  FC  GR  SH  SE
  SE  SH  GR  FC  SH  SH  GR  MT  MT  GR  SH  SH  FR  GR  GR  CT  GR  GR  GR  SH  SE  SE
  SE  FR  GR  GR  SH  SH  GR  GR  MT  SH  SH  GR  CT  GR  FR  GR  MT  GR  GR  SH  SE  SE
  SE  CT  GR  GR  GR  FC  MT  RV  SH  SH  CT  MT  GR  FR  GR  GR  GR  GR  CT  GR  SH  SE
  SE  SE  GR  GR  MT  RV  RV  RV  MT  GR  FR  RD  RD  RD  RD  CT  GR  FR  GR  GR  FR  SE
  SE  SE  SE  SH  SH  RV  MT  GR  FR 0LB  RD  RD  CT  BK  RD  RD  GR  MT  FR  GR  GR  SE
  SE  SE  SE  GR  SH  RV  GR  FR  GR  GR  RD  LB  MT  MT  MT  RD  FR  GR  GR  CT  GR  SE
  SE  SE  GR  SP  SH  GR  GR  GR  GR  GR  FR  MT  MT  GR  MT  MT  CT  BK  GR  GR  FR  SE
  SE  SE  SH  SE  SE  GR  CT  RD  FR  GR  GR  GR  GR  GR  GR  GR  GR  GR  GR  MT  GR  SE
  SE  SE  SE  SE  SE  FR  FR  RD  RD  FR  RD  CT  GR 0FC  GR  CT  RD  GR  FR  GR  SP  SE
  SE  SE  SH  SE  SE  SE  FR  GR  RD  RD  RD  GR  GR  GR  GR  GR  RD  FR  GR  FR  SE  SE
  SE  SE  TW  SE  SE  SE  SE  AP  GR  GR  GR  MT  MT  GR  MT  MT  RD  RD  RD  SE  SE  SE
  SH  CT  GR  GR  SH  SE  SE  SE  GR  CT  GR  GR  MT  MT  MT  GR  GR  GR  TW  SE  SE  SE

0, INFANTRY, 5, 16
1, INFANTRY, 8, 3
1, INFANTRY, 16, 7

