  TW  MT  MT  MT  CT  CT  GR  MT  MT  FR  SE  SE  AP  SH  SE  SE  SE  SH  FR  BK  FR  FC  MT  MT 9LB
  MT  MT 9FC  GR  GR  FR  GR  GR  GR  MT  CT  SE  SE  SE  SH  CT  SE  SE  BK  LB  BK  RD  RD  FC  MT
  MT  FR  RD  RD  GR  GR  FR  CT  GR  GR  MT  GR  GR  GR  GR  GR  SH  SE  FR  BK  FR  CT  RD  FR  MT
  MT  GR  FR  SP  SE  SE  SE  GR  GR  GR  GR  GR  CT  RD  FR  FR  CT  SH  SH  GR  GR  GR  RD  GR  FR
  CT  GR  GR  GR  SE  RF  SE  SE  SH  SH  SH  GR  GR  RD  CT  GR  GR  SH  SH  CT  GR  MT  BK  GR  CT
  RD  GR  GR  FR  SE  SE  SE  CT  SH  SH  SH  SH  SH  GR  GR  GR  FR  GR  SH  SH  GR  GR  GR  GR  GR
  RD  RD  GR  GR  SE  SH  RD  RD  GR  FR  CT  SE  SE  SE  GR  GR  GR  GR  SH  SH  GR  GR  CT  GR  MT
  GR  RD  RD  GR  SH  SH  RD  RD  GR  GR  SE  SH  CT  SE  SH 4FC  RD  RD  CT  SH  SH  BK  RD  FR  CT
  CT  FR  RD  BK  SH  SH  CT  RD  RD 9FC  SH  SE  CT  SH  SE  GR  GR  RD  RD  SH  SH  GR  RD  RD  GR
  MT  GR  CT  GR  GR  SH  SH  GR  GR  GR  GR  SE  SE  SE  CT  FR  GR  RD  RD  SH  SE  GR  GR  RD  RD
  GR  GR  GR  FR  GR  SH  SH  GR  FR  GR  GR  GR  SH  SH  SH  SH  SH  CT  SE  SE  SE  FR  GR  GR  RD
  CT  GR  BK  MT  GR  CT  SH  SH  GR  GR  CT  RD  GR  GR  SH  SH  SH  SE  SE  RF  SE  GR  GR  GR  CT
  FR  GR  RD  GR  GR  GR  SH  SH  CT  FR  FR  RD  CT  GR  GR  GR  GR  GR  SE  SE  SE  SP  FR  GR  MT
  MT  FR  RD  CT  FR  BK  FR  SE  SH  GR  GR  GR  GR  GR  MT  GR  GR  CT  FR  GR  GR  RD  RD  FR  MT
  MT  FC  RD  RD  BK  LB  BK  SE  SE  CT  SH  SE  SE  SE  CT  MT  GR  GR  GR  FR  GR  GR 4FC  MT  MT
 4LB  MT  MT  FC  FR  BK  FR  SH  SE  SE  SE  SH  AP  SE  SE  FR  MT  MT  GR  CT  CT  MT  MT  MT  TW
