  SE  SE  SE  SE  SE  SE  SE  SE  SE  SE  SE  SE  SE  SE  SE  SE  SE  SE  SE  SE  SE  SE  SE  SE  SE  SE  SE  SE  SE  SE  SE  SE
  SE  SE  SE  SE  SE  SE  SE  SE  SE  FR  FR  FR  SE  SE  SE  SE  SE  SE  SE  SE  SE  SE  SE  SE  GR  GR  GR  GR  GR  SE  SE  SE
  SE  SE  SE  SE  SE  SE  SE  SE  SE  FR  FR  FR  FR  GR  SE  SE  SE  SE  GR  FR  FR  FR  FR  FR  GR  FR  FR  FR  GR  GR  SE  SE
  SE  SE  SE  SE  SE  SE  SE  SE  SE  SE  GR  GR  GR  GR  MT  MT  MT  MT  GR  FR  FR  FR  FR  FR  GR  GR  GR  GR  FR  GR  SE  SE
  SE  SE  SE  SE  SE  SE  SE  SE  SE  SE  GR  CT  CT  CT  MT  MT  MT  MT  GR  GR  FR  FR  FR  FR  GR 1FC  GR 1FC  GR  GR  GR  SE
  SE  SE  GR  GR  FR  FR  FR  SE  SE  SE  MT  GR  GR  RD  GR  MT  GR  FR  FR  FR  FR  FR  FR  GR  GR  GR 1HQ  GR  GR  GR  GR  SE
  SE  SE  GR  FR  GR  GR  GR  GR  MT  MT  MT  MT  GR  RD  GR  MT  GR  MT  MT  GR  GR  FR  FR  GR  GR 1FC  RD 1FC  GR  GR  GR  SE
  SE  SE 0CT  GR 0FC  GR 0FC  GR  GR  MT  MT  MT  MT  RD  RD  RD  FC  RD  MT  MT  MT  GR  FR  FR  GR  GR  RD  GR  GR  FR  GR  SE
  SE  SE  GR  GR  GR 0HQ  GR  GR  GR  FR  FR  FR  FR  FR  FR  GR  GR  RD  GR  MT  MT  MT  GR  FR  FR  GR  RD  GR  FR  FR  GR  SE
  SE  SE  SE  MT 0FC  RD 0FC  GR  FR  FR  MT  MT  MT  MT  FR  GR  GR  RD  CT  FR  MT  MT  MT  GR  GR  CT  RD  CT  FR  FR  GR  SE
  SE  SE  SE  MT  MT  RD  GR  GR  FR  FR  FR  MT  MT  MT  FR  GR  CT  RD  GR  FR  MT  MT  MT  MT  MT  FR  RD  MT  GR  GR  GR  SE
  SE  SE  SE  MT  GR  RD  CT  GR  GR  GR  FR  MT  MT  MT  FR  FR  GR  RD  GR  FR  FR  MT  MT  MT  MT  MT  RD  FR  MT  GR  GR  SE
  SE  SE  SE  GR  CT  RD  MT  GR  GR  GR  GR  FR  MT  MT  MT  GR  GR  RD  GR  GR  GR  MT  MT  GR  GR  GR  RD  GR  MT  MT  MT  SE
  SE  SE  SE  GR  GR  RD  MT  CT  CT  CT  GR  FR  FR  FR  FR  CT  CT  RD  CT  CT  FR  FR  FR  CT  CT  CT  RD  CT  GR  MT  SE  SE
  SE  SE  GR  GR  CT  RD  RD  RD  RD  RD  RD  RD  RD  RD  RD  RD  RD  FC  RD  RD  RD  RD  RD  RD  RD  RD  RD  GR  GR  GR  SE  SE
  SE  SE  GR  GR  MT  GR  RD  MT  MT  GR  GR  GR  FR  FR  FR  FR  GR  RD  GR  GR  FR  FR  FR  FR  FR  RD  FR  GR  GR  GR  SE  SE
  SE  SE  MT  MT  MT  CT  RD  GR  MT  MT  MT  MT  MT  MT  FR  FR  GR  RD  GR  MT  MT  MT  FR  GR  GR  RD  GR  GR  GR  GR  SE  SE
  SE  SE  MT  MT  GR  GR  RD  CT  FR  MT  MT  MT  MT  MT  FR  GR  CT  RD  CT  GR  MT  MT  FR  GR  GR  RD  FR  GR  FR  GR  SE  SE
  SE  GR  GR  GR  GR  GR  RD  GR  FR  FR  MT  MT  MT  FR  FR  GR  GR  RD  GR  GR  MT  MT  FR  GR  CT  RD  GR  GR  GR  SE  SE  SE
  SE  GR  FR  GR  GR  GR  RD  GR  FR  MT  MT  MT  MT  FR  GR  GR  GR  RD  GR  FR  FR  FR  FR  GR  FR  RD  CT  GR  FR  SE  SE  SE
  SE  GR  GR  GR  GR 2FC  RD 2FC  GR  FR  MT  MT  MT  FR  GR  GR  GR  RD  GR  FR  MT  MT  GR  GR  FR  RD  FR  GR  GR  SE  SE  SE
  SE  GR  FR  GR  GR  GR 2HQ  GR  GR  FR  FR  FR  FR  FR  GR  GR  GR  RD  FR  MT  MT  MT  GR  GR  FR  RD  FR  GR  GR  SE  SE  SE
  SE  SE  GR  GR  GR 2FC  GR 2FC  GR  FR  MT  MT  MT  GR  GR  GR  GR  RD  GR  FR  MT  MT  MT  GR 3FC  RD 3FC  GR  SE  SE  SE  SE
  SE  SE  SE  SE  GR  GR  GR  GR  FR  MT  MT  MT  MT  FR  GR  CT  CT  RD  FC  GR  SE  SE  GR  GR  GR 3HQ  GR  GR  SE  SE  SE  SE
  SE  SE  SE  SE  SE  SE  FR  FR  MT  MT  MT  MT  FR  GR  GR  FR  FR  GR  SE  SE  SE  SE  GR  GR 3FC  GR 3FC  GR  SE  SE  SE  SE
  SE  SE  SE  SE  SE  SE  SE  SE  SE  SE  MT  FR  GR  GR  FR  GR  SE  SE  SE  SE  SE  SE  SE  GR  GR  GR  GR  SE  SE  SE  SE  SE
  SE  SE  SE  SE  SE  SE  SE  SE  SE  SE  SE  SE  SE  SE  SE  SE  SE  SE  SE  SE  SE  SE  SE  SE  SE  SE  SE  SE  SE  SE  SE  SE
  SE  SE  SE  SE  SE  SE  SE  SE  SE  SE  SE  SE  SE  SE  SE  SE  SE  SE  SE  SE  SE  SE  SE  SE  SE  SE  SE  SE  SE  SE  SE  SE
