  SE  SE  SE  SE  SE  SE  SE  SE  SE  SE  SE  SE  SE  SE  SE  SE  SE  SE  SE  SE  SE  SE  SE  SE  SE  SE  SE  SE  SE  SE  SE  SE  SE
  SE  SE  SE  SE  SE  SE  SE  GR  GR  GR  GR  RV  GR  GR  GR  SE  SE  SE  SE  SE  SE  GR  GR  RV  GR  FR  GR  SE  SE  SE  SE  SE  SE
  SE  SE  SE  GR  GR  FR  FR  GR  CT  CT  GR  RV  GR  CT  GR  GR  SE  SE  SE  FR  FR 1CT 1CT  RV  GR 1CT  FR  FR  GR  GR  SE  SE  SE
  SE  FR  FR  FR  RD  RD  RD  RD  RD  RD  RD  BR  RD  RD  RD  GR  SE  SE  SE  GR  RD  RD  RD  BR  RD  RD  GR  GR  FR  FR  GR  SE  SE
  SE  FR  FR  FR  RD  FR  GR  GR  GR  FR  FR  RV  GR  FR  RD  GR  SE  SE  SE  FC  RD  GR  FR  RV  GR  RD  GR 1FC  GR  GR 1CT  GR  SE
  SE  FR  FR 0FC  RD 0FC  GR  CT  CT  GR  GR  RV  GR  GR  RD  CT  SE  SE  SE  FR  RD  CT  SE  SE  SE  RD 1FC 1HQ 1FC  GR  FR  FR  SE
  SE  FR  GR  GR 0HQ  GR  GR  GR  GR  FR  SE  SE  SE  GR  RD  FR  SE  SE  SE  GR  RD  GR  SE  SE  SE  RD  RD 1FC  GR  GR  FR  FR  SE
  SE  GR  GR 0FC  RD 0FC  GR  FR  FR  FR  SE  SE  SE  FC  RD  GR  SE  SE  SE  AP  RD  FR  SE  SE  SE  GR 1AP  GR 1AP  GR  FR  FR  SE
  SE  GR  GR 0AP  RD 0AP  GR  GR  GR  FR  SE  SE  SE  GR  RD  GR  GR  SE  GR  GR  RD  GR  SE  SE  SE  GR  GR  GR  GR 1CT 1CT  GR  SE
  SE  GR 0CT 0CT  RD 0CT 0CT  FR  FR  FR  SE  SE  SE  FR  RD  GR  CT  GR  CT  FR  RD  CT  SE  SE  SE 1CT 1CT  GR  GR  MT  GR  SE  SE
  SE  SE  GR  GR  GR  GR  FR  FR  FR  FR  SE  SE  SE  GR  RD  RD  RD  RD  RD  RD  RD  FR  SE  SE  SE  FR  GR  MT  MT  SE  SE  SE  SE
  SE  SE  SE  GR  FR  FR  FR  FR  SE  SE  SE  SE  SE  SE  GR  FR  FR  CT  FR  FR  FR  SE  SE  SE  SE  GR  SE  SE  SE  SE  SE  SE  SE
  SE  SE  SE  SE  SE  SE  SE  SE  SE  SE  SE  SE  SE  SE  SE  SE  SE  SE  SE  SE  SE  SE  SE  SE  SE  SE  SE  SE  SE  SE  SE  SE  SE
