  SE  SE  SE  SE  SE  SE  SE  SE  SE  SE  SE  SE  SE  SE  SE
  SE  SE  GR  FR  RD  RD  BR  RD  RD  GR  FR 1FC  GR 1FC  SE
  SE  GR  GR  FR  RD  FR  SE  GR  RD  CT  GR  GR 1HQ 1FC  SE
  SE  CT  CT  RD  RD  SE  SE  SE  RD  GR  MT  GR  RD 1FC  SE
  SE  GR  GR  RD  GR  SE  SE  SE  RD  CT  MT  CT  RD  GR  SE
  SE 0FC  RD  RD  CT  SE  SE  FR  RD  RD  RD  RD  RD  CT  SE
  SE 0FC 0HQ  GR  GR  GR  GR  FR  FR  GR  SE  SE  BR  SE  SE
  SE  SE 0FC 0FC  GR  GR  GR  GR  GR  GR  SE  SE  GR  GR  SE
  SE  SE  SE  SE  MT  CT  MT  FR  CT  GR  BR  GR  CT  CT  SE
  RF  SE  SE  SE  SE  SE  SE  SE  SE  SE  SE  SE  SE  SE  SE
team, unit type, x, y (author: Advance Wars 2)
