  SE  SE  SE  SE  SE  SE  SE  SE  SE  SE  SE  SE  SE  SE  SE  SE  SE  SE  SE
  SE  SE  SE  SE  SE  SE  SE  SE  SE  SE  SE  SE  SE  SE  SE  SE  SE  SE  SE
  SE  SE  SE  RF  SE  SE  SE  SE  SE  SE  SE  SE  GR  FR  GR 1FC  GR  FR  SE
  SE  SE  SE  SE  SE  SE  SE  SE  CT  RD  RD  RD  RD  RD  RD  RD 1HQ  GR  SE
  SE  SE  SE  SE  SE  SE  SE  MT  GR  RD  GR  FR  GR  CT  CT  GR  GR 1FC  SE
  SE  SE  SE  SE  SE  FR  GR  FR  FR  RD  CT  GR  GR  FR  GR  FR  GR  SE  SE
  SE  SE  FR  GR  GR  GR  FR  GR  CT  RD  FR  FR  FR  GR  SE  SE  SE  SE  SE
  SE 0FC  GR  GR  CT  CT  FR  FR  GR  RD  GR  MT  SE  SE  SE  SE  SE  SE  SE
  SE  GR 0HQ  RD  RD  RD  RD  RD  RD  RD  CT  SE  SE  SE  SE  SE  SE  SE  SE
  SE  FR  GR 0FC  GR  FR  GR  SE  SE  SE  SE  SE  SE  SE  SE  RF  RF  SE  SE
  SE  SE  SE  SE  SE  SE  SE  SE  SE  SE  SE  SE  SE  SE  SE  SE  SE  SE  SE
  SE  SE  SE  SE  SE  SE  SE  SE  SE  SE  SE  SE  SE  SE  SE  SE  SE  SE  SE
team, unit type, x, y (author: DSMaps2)
