  SE  SE  SE  SE  SE  SE  SE  SE  SE  SE  SE  SE  SE  SE  SE  SE
  SE  SE  SE  SE  SE  SE  GR  GR  GR  GR  GR  GR  SE  SE  SE  SE
  SE  SE  SE  SE 0FC 0HQ 0FC  RD 0CT 0CT 0CT  CT  GR  GR  SE  SE
  SE  SE  GR  GR  RD 0FC  GR  GR  GR  GR  GR  FR  FR  FR  FR  SE
  SE  GR 0CT 0FC  RD  GR  GR  GR 0CT  CT  FR  FR  FR  FR  GR  SE
  SE  GR  GR  RD  RD 0CT  GR  SE  GR  FR  FR  FR  FR  FR  CT  SE
  SE  GR  GR  RD  GR  GR  SE  SE  GR  SE  SE  GR  FR  FR  FR  SE
  SE  MT  GR  RD  MT  SE  SE  SE  SE  SE  SE  CT  FR  FR  GR  SE
  SE  GR  RD  RD  GR  SE  SE  SE  SE  SE  SE  FR  FR  FR  CT  SE
  SE  CT  RD  GR  CT  SE  SE  GR  GR  SE  GR  FR  FR  FR  FR  SE
  SE  GR  RD  MT  GR  GR  GR  CT  GR  GR  GR  GR  GR  GR  GR  SE
  SE  CT  RD  RD  RD  MT  GR  GR  CT  GR  GR  FC  GR  FC  CT  SE
  SE  SE  GR  GR  RD  RD  RD  GR  GR  FC  GR 1FC  GR  GR  SE  SE
  SE  SE  SE  CT  GR  GR  RD  RD  CT  GR 1FC 1HQ 1FC  SE  SE  SE
  SE  SE  SE  SE  SE  SE  SE  SE  SE  SE  SE  SE  SE  SE  SE  SE
