  MT  AP  MT  MT  MT  GR  GR  GR  FR  GR  CT  CT  MT  MT  MT  FR  GR  FR  MT  MT  MT  MT  MT
  MT  MT  FR  GR  GR  FR  BK  CT  GR  GR  GR  GR  GR  MT  GR  CT  GR  GR  FC  GR  MT  MT  MT
  MT  MT  GR  GR  GR  GR  FR  GR  GR  MT  GR  CT  GR  FR  GR  GR  GR  MT  GR  SH  SH  MT  MT
  MT  GR  GR  MT  CT  GR  TW  RD  RD  RD  RD  RD  RD  RD  GR  GR  MT  GR  GR  SH  SH  GR  MT
  CT  GR  FR  GR  GR  GR  RD  RD  FR  GR  GR  GR  GR  RD  RD  FR  GR  BK  CT  GR 5FC  GR  MT
  FR  FR  RD  RD  RD  RD  RD  MT  FR  CT  MT  GR  GR  GR  RD  RD  GR  GR  GR  GR  FR  FR  CT
  MT  RD  RD  CT  GR  GR  CT  MT  MT  MT  GR  GR  CT  CT  GR  RD 5HQ  MT  MT  GR  GR  FR  FR
  RD  RD  RD  GR  GR  MT  MT  GR  GR  CT  GR  FR  SH  SH  GR  RD  GR  GR  CT  MT  MT  FR  MT
  RD10FC  RD  BK  MT  GR  GR  FR  GR  RD  RD  GR  SH  SH  RD  RD  SH  SH  GR  MT  FR  MT  CT
  RD  RD  RD  GR  MT  SH  SH  CT  RD  RD  RD  CT  RD  RD  RD  CT  SH  SH  MT  GR  RD  RD  RD
  CT  MT  FR  MT  GR  SH  SH  RD  RD  SH  SH  GR  RD  RD  GR  FR  GR  GR  MT  BK  RD 5FC  RD
  MT  FR  MT  MT  CT  GR  GR  RD  GR  SH  SH  FR  GR  CT  GR  GR  MT  MT  GR  GR  RD  RD  RD
  FR  FR  GR  GR  MT  MT10HQ  RD  GR  CT  CT  GR  GR  MT  MT  MT  CT  GR  GR  CT  RD  RD  MT
  CT  FR  FR  GR  GR  GR  GR  RD  RD  GR  GR  GR  MT  CT  FR  MT  RD  RD  RD  RD  RD  FR  FR
  MT  GR10FC  GR  CT  BK  GR  FR  RD  RD  GR  GR  GR  GR  FR  RD  RD  GR  GR  GR  FR  GR  CT
  MT  GR  SH  SH  GR  GR  MT  GR  GR  RD  RD  RD  RD  RD  RD  RD  TW  GR  CT  MT  GR  GR  MT
  MT  MT  SH  SH  GR  MT  GR  GR  GR  FR  GR  CT  GR  MT  GR  GR  FR  GR  GR  GR  GR  MT  MT
  MT  MT  MT  GR  FC  GR  GR  CT  GR  MT  GR  GR  GR  GR  GR  CT  BK  FR  GR  GR  FR  MT  MT
  MT  MT  MT  MT  MT  FR  GR  FR  MT  MT  MT  CT  CT  GR  FR  GR  GR  GR  MT  MT  MT  AP  MT
team, unit type, x, y
10, INFANTRY, 2, 14