  SH  SH  MT  GR  FR  GR 1FC  GR  CT  GR  GR  GR  AP  GR  RD  GR  SH  SE  SE  SE
  MT  MT  GR  CT  GR  GR  RD  GR  GR  GR  GR  FR  FR  RD  RD  CT  GR  GR  SE  SE
  CT  GR  GR  GR  GR  RD  RD  GR  MT  GR  CT  BR  GR  RD  GR  GR  FR  GR  CT  SH
  GR  GR  GR  GR  GR  CT  FR  FR  GR  GR  GR  RV  GR  RD  GR 1FC  GR  MT  GR  GR
  GR  GR  FR  GR  RD  RD  GR  GR 1HQ  FR  MT  RV  CT  RD  RD  RD  GR  GR  GR  BK
  GR  CT  RD  RD  RD  GR  GR  GR  GR  RV  RV  RV  GR  GR  FR  RD  GR  GR  FR  GR
  RD  RD  RD  GR  TW  GR  FR  CT  RD  GR  GR  GR  GR  GR  GR  RD  CT  GR  GR  GR
  GR  FR  GR  GR  GR  GR  GR  GR  RD  RD  CT  RD  FR  GR  GR  GR  RD  RD  GR  CT
  MT  GR  CT  MT  GR  GR  GR  GR  GR  GR  GR  RD  RD  CT  GR  BK  GR  RD  RD  RD
  RD  RD  RD  GR  BK  GR  CT  RD  RD  GR  GR  GR  GR  GR  GR  GR  MT  CT  GR  MT
  CT  GR  RD  RD  GR  GR  GR  FR  RD  CT  RD  RD  GR  GR  GR  GR  GR  GR  FR  GR
  GR  GR  GR  CT  RD  GR  GR  GR  GR  GR  GR  RD  CT  FR  GR  TW  GR  RD  RD  RD
  GR  FR  GR  GR  RD  FR  GR  GR  RV  RV  RV  GR  GR  GR  GR  RD  RD  RD  CT  GR
  BK  GR  GR  GR  RD  RD  RD  CT  RV  MT  FR 7HQ  GR  GR  RD  RD  GR  FR  GR  GR
  GR  GR  MT  GR 7FC  GR  RD  GR  RV  GR  GR  GR  FR  FR  CT  GR  GR  GR  GR  GR
  SH  CT  GR  FR  GR  GR  RD  GR  BR  CT  GR  MT  GR  RD  RD  GR  GR  GR  GR  CT
  SE  SE  GR  GR  CT  RD  RD  FR  FR  GR  GR  GR  GR  RD  GR  GR  CT  GR  MT  MT
  SE  SE  SE  SH  GR  RD  GR  AP  GR  GR  GR  CT  GR 7FC  GR  FR  GR  MT  SH  SH

7, INFANTRY, 4, 14