  FR  SH  SH  MT  SH  SH  SH  GR  RD  GR  GR  SP  MT  GR  RD  RD  RD  CT  SH
  FR  GR  GR10FC  GR  FR  GR10FC  RD  GR  FR  GR  GR  RD  RD  CT  FR  GR  SH
  AP  GR  MT  GR  RD  RD  RD  GR  GR  MT  GR  GR  CT  GR  GR  GR  GR  GR  BK
  GR  RD  GR  CT  FR  MT  RD  CT  GR  RD  TW  FR  GR  MT  GR  GR  CT  RD  RD
  SH  FC  RV  GR  FR  GR  RD  GR  GR  GR  GR  MT  GR  GR  RD  GR  FR  RD 5HQ
  GR  RD  BR  FR  GR  AP  GR  GR  FR  RD  RD  GR  CT  FR  RD  CT  RV  RD  FR
  BK  RD  RV  MT  GR  GR  MT  CT  GR  BK  GR  GR  RD  RD  GR  GR  RV  CT  GR
  GR  CT  RV  GR  GR  RD  RD  GR  GR  BK  GR  CT  MT  GR  GR  MT  RV  RD  BK
  FR  RD  RV  CT  RD  FR  CT  GR  RD  RD  FR  GR  GR  AP  GR  FR  BR  RD  GR
10HQ  RD  FR  GR  RD  GR  GR  MT  GR  GR  GR  GR  RD  GR  FR  GR  RV  FC  SH
  RD  RD  CT  GR  GR  MT  GR  FR  TW  RD  GR  CT  RD  MT  FR  CT  GR  RD  GR
  BK  GR  GR  GR  GR  GR  CT  GR  GR  MT  GR  GR  RD  RD  RD  GR  MT  GR  AP
  SH  GR  FR  CT  RD  RD  GR  GR  FR  GR  RD 5FC  GR  FR  GR 5FC  GR  GR  FR
  SH  CT  RD  RD  RD  GR  MT  SP  GR  GR  RD  GR  SH  SH  SH  MT  SH  SH  FR

10, INFANTRY, 3, 1