  FR  FR  GR  MT  MT  FR  FR  SH  SE  SE  SE  CT  CT  SE  SE  SH  GR  GR  GR  TW  FR  CT
  FR  CT  AP  GR  MT  GR  GR  GR  CT  SH  SE  SH  SE  SE  SE  RV  RV  CT  GR  GR  GR  GR
  FR  RD  GR  GR  GR  GR 1FC  GR  GR  GR  SE  SE  SE  SE  SP  FR  RV  RV 1FC  GR  GR  FR
  GR  RD  CT  FR  GR  GR  GR  GR  RV  RV  SE  SE  SE  GR  GR  GR  CT  RV  BR  RV  GR  MT
  RV  RD  GR  GR  GR  CT  RV  BR  RV  FR  FR  SH  SH  GR  FR  GR  GR  FR  RD  RV  FC  MT
  RV  BR  RV  GR  GR  RD  BR  RD  CT  FR 1HQ  SH  SH  GR  MT  GR  GR  GR  RD  BR  RD  GR
  GR  GR  RV  BR  FR  BR  RV  GR  GR  GR  GR  SH  SH  GR  CT  CT  RV  RV  RV  RV  RD  FR
  TW  GR  CT  RD  GR  GR  SP  GR  GR  GR  SH  SH  GR  GR  GR  RV  RV  CT  GR  GR  FC  FR
  GR  GR  GR  RD  RD  GR  SP  GR  FR  GR  SH  SH  CT  RD  RD  BR  RD  GR  GR  GR  MT  FR
  CT  GR  FR  GR  RD  SE  SE  GR  GR  CT  SH  SH  GR  RD  RD  BR  RD  RD  CT  MT  MT  RV
  RV  RV  BR  FR  BR  SE  SE  RD  RD  GR  SH  SH  GR  RD  RD  SE  SE  BR  FR  BR  RV  RV
  RV  MT  MT  CT  RD  RD  BR  RD  RD  GR  SH  SH  CT  GR  GR  SE  SE  RD  GR  FR  GR  CT
  FR  MT  GR  GR  GR  RD  BR  RD  RD  CT  SH  SH  GR  FR  GR  SP  GR  RD  RD  GR  GR  GR
  FR  FC  GR  GR  CT  RV  RV  GR  GR  GR  SH  SH  GR  GR  GR  SP  GR  GR  RD  CT  GR  TW
  FR  RD  RV  RV  RV  RV  CT  CT  GR  SH  SH  GR  GR  GR  GR  RV  BR  FR  BR  RV  GR  GR
  GR  RD  BR  RD  GR  GR  GR  MT  GR  SH  SH 7HQ  FR  CT  RD  BR  RD  GR  GR  RV  BR  RV
  MT  FC  RV  RD  FR  GR  GR  FR  GR  SH  SH  FR  FR  RV  BR  RV  CT  GR  GR  GR  RD  RV
  MT  GR  RV  BR  RV  CT  GR  GR  GR  SE  SE  SE  RV  RV  GR  GR  GR  GR  FR  CT  RD  GR
  FR  GR  GR 7FC  RV  RV  FR  SP  SE  SE  SE  SE  GR  GR  GR 7FC  GR  GR  GR  GR  RD  FR
  GR  GR  GR  GR  CT  RV  RV  SE  SE  SE  SH  SE  SH  CT  GR  GR  GR  MT  GR  AP  CT  FR
  CT  FR  TW  GR  GR  GR  SH  SE  SE  CT  CT  SE  SE  SE  SH  FR  FR  MT  MT  GR  FR  FR
team, unit type, x, y
7, INFANTRY, 3, 18