  SE  SE  SH  SH  GR  GR  RD  FR  RD  RD  FR  CT  GR  RD  RD  CT  GR  MT  MT  SH
  SE  SE  FR  GR 6FC  RD  RD  GR  GR  RD  RD  FR  RD  RD  FR  GR  GR  GR  FR  MT
  GR  GR  GR  GR  MT  MT  GR  CT  GR  GR  RD  GR  TW  GR  GR  GR  RD  CT  RD  GR
  FR  GR  MT 6FC  MT  FR  FR  GR  MT  GR  BR  RV  FR  GR  GR  MT  RD  GR  RD  GR
  GR  AP  MT  GR  GR  FR  GR  GR  GR  FR  CT  RV  GR  GR  FR  GR  SH  RV  BR  SH
  MT  RD  GR  FR  GR  CT  MT  MT  GR  GR  GR  RV  SH  BR  SE  RV  SH  GR  CT  SH
  GR  RD  RD  GR  MT  BR  MT  GR  FR 6HQ  GR  FR  SH  CT  SH  GR  FR  GR  FR  SH
  GR  GR  CT  GR  MT  RD  RD  CT  GR  FR  MT  GR  SH  SH  SH  FR  GR  GR  GR  SH
  CT  GR  FR  GR  GR  GR  FR  GR  GR  GR  GR  GR  GR  FR  GR  GR  GR  FR  GR  CT
  SH  GR  GR  GR  FR  SH  SH  SH  GR  MT  FR  GR  CT  RD  RD  MT  GR  CT  GR  GR
  SH  FR  GR  FR  GR  SH  CT  SH  FR  GR 4HQ  FR  GR  MT  BR  MT  GR  RD  RD  GR
  SH  CT  GR  SH  RV  SE  BR  SH  RV  GR  GR  GR  MT  MT  CT  GR  FR  GR  RD  MT
  SH  BR  RV  SH  GR  FR  GR  GR  RV  CT  FR  GR  GR  GR  FR  GR  GR  MT  AP  GR
  GR  RD  GR  RD  MT  GR  GR  FR  RV  BR  GR  MT  GR  FR  FR  MT 4FC  MT  GR  FR
  GR  RD  CT  RD  GR  GR  GR  TW  GR  RD  GR  GR  CT  GR  MT  MT  GR  GR  GR  GR
  MT  FR  GR  GR  GR  FR  RD  RD  FR  RD  RD  GR  GR  RD  RD 4FC  GR  FR  SE  SE
  SH  MT  MT  GR  CT  RD  RD  GR  CT  FR  RD  RD  FR  RD  GR  GR  SH  SH  SE  SE
team, unit type, x, y
6, INFANTRY, 3, 3