  SH  FR  PI  GR  CT  FR  GR  RD  CT  GR  RD  CT  GR  FR  SH
  SH  GR  RD  GR  GR  GR  AP  RD  GR  PI  BR  RD  GR  FR  SH
  RD  RD  RD  CT  MT  RD  RD  GR  FR  PI  RD  RD  RD  RD 8HQ
  RD  CT  GR  GR  GR  GR  GR  CT  BK  GR  GR  BK  CT  RD  FR
  RD  GR  MT  FR  FC  GR  FR  MT  RD  FR  CT  GR  FR  RD  GR
  FR  GR  BK  GR  RD  GR  GR  CT  RD  GR  GR  SH  RV  RD  CT
  SH 6FC  RD  RD  RD  TW  FR  RD  FR  SH  BR  SH  GR  GR  GR
  SE  GR  CT  FR  GR  FR  RD  RD  SH  SH  GR  FR  RD 8FC  SH
  SE  FR  GR  RD  GR  CT  RV  RV  SH  BK  GR  CT  RD  MT  SH
  SH  CT  GR  RD  FR  GR  MT  LB  MT  GR  FR  RD  GR  CT  SH
  SH  MT  RD  CT  GR  BK  SH  RV  RV  CT  GR  RD  GR  FR  SE
  SH 6FC  RD  FR  GR  SH  SH  RD  RD  FR  GR  FR  CT  GR  SE
  GR  GR  GR  SH  BR  SH  FR  RD  FR  TW  RD  RD  RD 8FC  SH
  CT  RD  RV  SH  GR  GR  RD  CT  GR  GR  RD  GR  BK  GR  FR
  GR  RD  FR  GR  CT  FR  RD  MT  FR  GR  FC  FR  MT  GR  RD
  FR  RD  CT  BK  GR  GR  BK  CT  GR  GR  GR  GR  GR  CT  RD
 6HQ  RD  RD  RD  RD  PI  FR  GR  RD  RD  MT  CT  RD  RD  RD
  SH  FR  GR  RD  BR  PI  GR  RD  AP  GR  GR  GR  RD  GR  SH
  SH  FR  GR  CT  RD  GR  CT  RD  GR  FR  CT  GR  PI  FR  SH

6,LANDER,1,8
8,INFANTRY,13,12
8,LANDER,13,10