  RF  RF  SE  SE  SE  SE  SE  SE  SE  SE  SE  RF  SE  SE  SE  SE  SE  SE  SE  SH  CT  CT
  SE  SE  SH  SH  CT  GR  SP  GR  FR  FR  SE  SE  SH  SH  CT  SH  SH  SE  SE  SE  SH  SH
  SH  GR  GR  RD  RD  RD  GR  GR  BK  GR  GR  SH  TW  SE  SE  SH  GR  FR  CT  SE  SE  SE
  GR  GR  RD 6FC  FR  GR  GR 6FC  GR  GR  CT  FR  SH  SH  SH  GR 6AP  GR  GR  GR  SH  SE
  GR  CT  FR  FR  SH  SH  GR  GR  RD  RD  GR  SH  SE  SH  CT  GR  RD  RD  RD  GR  CT  SH
  GR  RD  GR  SH  AP  GR  CT  RD  FR  GR  GR  SH  SH  SE  GR  GR  GR  CT  RD  FR  GR  SH
  FC  RD  GR  SH  GR  GR  GR  RD  GR  MT  CT  GR  SH  CT  FR  GR  GR  FR  GR  CT  GR  GR
  GR  RD  RD  GR  GR  BK  RD  RD  BK  FR  FR  SH  SH  GR  FR  RD  CT  SH  SE  SH  SH  SE
  GR  GR  RD  CT  GR  RD  FR  GR  MT  BK  SH  SH  CT  GR  GR  RD  RD  SH 8LB  SH  SE  GR
  CT  GR  FR  MT  GR  RD  CT  GR  SH  SH  SH  SH  SH  SH  GR  CT  RD  GR  MT  FR  GR  CT
  GR  SE  SH 6LB  SH  RD  RD  GR  GR  CT  SH  SH  BK  MT  GR  FR  RD  GR  CT  RD  GR  GR
  SE  SH  SH  SE  SH  CT  RD  FR  GR  SH  SH  FR  FR  BK  RD  RD  BK  GR  GR  RD  RD  GR
  GR  GR  CT  GR  FR  GR  GR  FR  CT  SH  GR  CT  MT  GR  RD  GR  GR  GR  SH  GR  RD  FC
  SH  GR  FR  RD  CT  GR  GR  GR  SE  SH  SH  GR  GR  FR  RD  CT  GR  AP  SH  GR  RD  GR
  SH  CT  GR  RD  RD  RD  GR  CT  SH  SE  SH  GR  RD  RD  GR  GR  SH  SH  FR  FR  CT  GR
  SE  SH  GR  GR  GR 8AP  GR  SH  SH  SH  FR  CT  GR  GR 8FC  GR  GR  FR 8FC  RD  GR  GR
  SE  SE  SE  CT  FR  GR  SH  SE  SE  TW  SH  GR  GR  BK  GR  GR  RD  RD  RD  GR  GR  SH
  SH  SH  SE  SE  SE  SH  SH  CT  SH  SH  SE  SE  FR  FR  GR  SP  GR  CT  SH  SH  SE  SE
  CT  CT  SH  SE  SE  SE  SE  SE  SE  SE  RF  SE  SE  SE  SE  SE  SE  SE  SE  SE  RF  RF

8, CARRIER, 21, 5
6, CARRIER, 0, 13
8, INFANTRY, 18, 15