  FR  CT  GR  GR  MT  MT  TW  GR  GR  AP  MT  BR  RD  RD  CT  FR  MT  MT
  GR  MT  GR  CT  RD  RD  RD  GR  RD  RD  RD  BR  GR  RD 4FC  MT  MT  FR
  GR  RD  RD  RD  RD  GR  RD  RD  RD  GR  GR  RV  RV  GR  RD  GR  CT  FR
  RD  RD  GR  GR  MT  FR  FR  CT  GR  FR  CT  GR  RV  RV  RD  RD  GR  MT
  FR  GR15HQ  GR  FR  CT  MT  GR  MT  GR  FR  RD  RD  BR  RD  RD  RD 4FC
  GR  FR  RD  RD  GR  MT  GR  GR  GR  GR  RD  RD  CT  RV  RV  FR  RD  MT
  AP  GR  GR  RD  RD  RD  RD  GR  CT  GR  RD  GR  FR  MT  RV  BR  BR  RV
  RV  RD  RD  GR  GR  GR  RD  RD  FR  FR  RD  RD  GR  GR  GR  RD  RD  RV
  RV  BR  BR  RV  MT  FR  GR  RD  GR  CT  GR  RD  RD  RD  RD  GR  GR  AP
  MT  RD  FR  RV  RV  CT  RD  RD  GR  GR  GR  GR  MT  GR  RD  RD  FR  GR
15FC  RD  RD  RD  BR  RD  RD  FR  GR  MT  GR  MT  CT  FR  GR 4HQ  GR  FR
  MT  GR  RD  RD  RV  RV  GR  CT  FR  GR  CT  FR  FR  MT  GR  GR  RD  RD
  FR  CT  GR  RD  GR  RV  RV  GR  GR  RD  RD  RD  GR  RD  RD  RD  RD  GR
  FR  MT  MT15FC  RD  GR  BR  RD  RD  RD  GR  RD  RD  RD  CT  GR  MT  GR
  MT  MT  FR  CT  RD  RD  BR  MT  AP  GR  GR  TW  MT  MT  GR  GR  CT  FR
team, unit type, x, y
4, INFANTRY, 14, 1
15, INFANTRY, 0, 10
15, INFANTRY, 3, 13