  SE  SE  SE  RF  SE  SE  SE  SE  SE  SE  RF  SE  SE  SE  SE  SE  SE  RF  SE  SE  SE  SE  SE  SE  SE  SE  SE  SE  RF
  SE  SH  CT  SE  SE  SH  SH  SH  SP  SH  SE  SH  SE  SH  SH  SH  SE  SE  SH  SH  SH  SE  SE  RF  SE  SE  SH  SE  SE
  RF  SE  SH  SE  SH  FR  GR  GR  RD  FR  SH  CT  SH  GR  GR  CT  SH  SH  RD  CT  BK  SH  SE  SE  SE  SH  SP  SE  SE
  SE  SE  SE  SE  SH  GR  CT  RD  RD  GR  SH  SH  SH  GR  FR  RD  SE  SE  RD  RD  FR  SH  SH 1FC  SE  SE  SH  SE  SE
  CT  SH  SE  SH  GR  GR  GR  FR  RD  CT  GR  FR  GR  CT  RD  RD  GR  GR  RD  MT  SH  SE  SE  SH  SE  SE  SE  RF  SE
  SH  SE  SE  SH  CT  GR  GR  GR  GR  RD  RD  RD  GR  GR  RD  GR  FR  RD  CT  SH  SE  SE  SE  SH  GR  FC  SE  SE  SE
  SE  SE  SH  GR  RD  FR  GR  TW  GR  FR  GR  CT  GR  FR  RD  CT  RD  RD  GR  SH  SH  FR  AP  SH  SE  SH  SE  SE  SE
  SE  SH  CT  GR  RD  RD  RD  RD  GR  GR  GR  GR  GR  GR  GR  GR  MT  GR  FR  SE  SE  SE  SE  SE  SE  SH  SE 1FC  SE
  RF  SE  SH  GR  GR  GR  RD  FR  GR  CT  RD  RD  RD  CT  GR  GR  GR  BK  GR 1HQ  SH  SE  SE  SE  SH  GR  SE  SH  SE
  SE  SH  SH  FR  GR  GR  CT  SH  SH  GR  RD  FR  GR  GR  GR  FR  GR  RD  RD  RD  RD  SE  SH  SH  FR  SE  SE  SH  SE
  SE  CT  RD  RD  GR  MT  GR  SH  SH  GR  RD  RD  GR  SH  SH  SH  GR  GR  GR  GR  RD  SP  GR  BK  RD  SH  SH  FR  SE
  SE  GR  GR  RD  RD  GR  FR  GR  GR  FR  GR  CT  GR  SH  LB  SH  GR  CT  GR  FR  GR  GR  FR  GR  RD  RD  GR  GR  SE
  SE  FR  SH  SH  RD  BK  GR  SP  RD  GR  GR  GR  GR  SH  SH  SH  GR  RD  RD  GR  SH  SH  GR  MT  GR  RD  RD  CT  SE
  SE  SH  SE  SE  FR  SH  SH  SE  RD  RD  RD  RD  GR  FR  GR  GR  GR  FR  RD  GR  SH  SH  CT  GR  GR  FR  SH  SH  SE
  SE  SH  SE  GR  SH  SE  SE  SE  SH 0HQ  GR  BK  GR  GR  GR  CT  RD  RD  RD  CT  GR  FR  RD  GR  GR  GR  SH  SE  RF
  SE 0FC  SE  SH  SE  SE  SE  SE  SE  SE  FR  GR  MT  GR  GR  GR  GR  GR  GR  GR  GR  RD  RD  RD  RD  GR  CT  SH  SE
  SE  SE  SE  SH  SE  SH  AP  FR  SH  SH  GR  RD  RD  CT  RD  FR  GR  CT  GR  FR  GR  TW  GR  FR  RD  GR  SH  SE  SE
  SE  SE  SE  FC  GR  SH  SE  SE  SE  SH  CT  RD  FR  GR  RD  GR  GR  RD  RD  RD  GR  GR  GR  GR  CT  SH  SE  SE  SH
  SE  RF  SE  SE  SE  SH  SE  SE  SH  MT  RD  GR  GR  RD  RD  CT  GR  FR  GR  CT  RD  FR  GR  GR  GR  SH  SE  SH  CT
  SE  SE  SH  SE  SE 0FC  SH  SH  FR  RD  RD  SE  SE  RD  FR  GR  SH  SH  SH  GR  RD  RD  CT  GR  SH  SE  SE  SE  SE
  SE  SE  SP  SH  SE  SE  SE  SH  BK  CT  RD  SH  SH  CT  GR  GR  SH  CT  SH  FR  RD  GR  GR  FR  SH  SE  SH  SE  RF
  SE  SE  SH  SE  SE  RF  SE  SE  SH  SH  SH  SE  SE  SH  SH  SH  SE  SH  SE  SH  SP  SH  SH  SH  SE  SE  CT  SH  SE
  RF  SE  SE  SE  SE  SE  SE  SE  SE  SE  SE  RF  SE  SE  SE  SE  SE  SE  RF  SE  SE  SE  SE  SE  SE  RF  SE  SE  SE
team, unit type, x, y (author: wyj_0081)
1, infantry, 23, 3
