  RD  RD  RD  FC  RD  BR  RD  RD  RV  RV  BK  RD  GR  BR  CT  SH  SH
  BR  RV  BR  RV  BR  RV  GR  AP  PI  CT  RV  BR  RV  RV  GR  PI 0FC
  RD  PI  BK  FR  CT  PI  ME  PI  RV  BR  RV  RD  CT  GR  FR  ME  BK
 0FC  PI  MT  GR  MT  GR  GR  GR  PI  FR  RD  RD  GR  GR  GR  PI  MT
  MT  GR  CT  RD  RD  RD  CT  GR  RV  GR 0HQ  GR  FR  RD  CT  GR  FR
  GR  GR  GR  RD  MT  GR  RD  FR  BR  GR  GR  RD  RD  RD  GR  GR  GR
  CT  GR  FR  RD  RV  BR  BR  RV  RV  BR  BR  BR  RV  GR  FR  GR  CT
  RD  RD  GR  RD  BR  GR  CT  GR  RV  GR  GR  GR  RV  GR  GR  GR  RD
  MT  RD  TW  GR  BR  FR  GR  GR  BR  LB  RD  FR  BR  GR  CT  RD  RD
  GR  GR  GR  GR  RV  GR  MT  GR  BR  GR  RD  RD  BR  GR  GR  GR  RD
  CT  GR  FR  BK  BR  CT  GR  GR  RV  GR  GR  CT  BR  BK  FR  GR  CT
  RD  GR  GR  GR  BR  RD  RD  GR  BR  GR  MT  GR  RV  GR  GR  GR  GR
  RD  RD  CT  GR  BR  FR  RD  LB  BR  GR  GR  FR  BR  GR  TW  RD  MT
  RD  GR  GR  GR  RV  GR  GR  GR  RV  GR  CT  GR  BR  RD  GR  RD  RD
  CT  GR  FR  GR  RV  BR  BR  BR  RV  RV  BR  BR  RV  RD  FR  GR  CT
  GR  GR  GR  RD  RD  RD  GR  GR  BR  FR  RD  GR  MT  RD  GR  GR  GR
  FR  GR  CT  RD  FR  GR 1HQ  GR  RV  GR  CT  RD  RD  RD  CT  GR  MT
  MT  PI  GR  GR  GR  RD  RD  FR  PI  GR  GR  GR  MT  GR  MT  PI 1FC
  BK  ME  FR  GR  CT  RD  RV  BR  RV  PI  ME  PI  CT  FR  BK  PI  RD
 1FC  PI  GR  RV  RV  BR  RV  CT  PI  AP  GR  RV  BR  RV  BR  RV  BR
  SH  SH  CT  BR  GR  RD  BK  RV  RV  RD  RD  BR  RD  FC  RD  RD  RD
team, unit type, x, y (author: wyj_0081)
1, infantry, 16, 17
