  RV  RV  RD  BR  RD  BR  RD  RD  RD  MT  RD  RD  RD  SH  SH  SH  MT  MT  RV  MT  MT  CT  PI
  CT  BR  BK  BR  CT  BR  FR  MT 1HQ  RD  RD  FR  CT  GR  GR  RD  RD 1FC  RV  RV  RV  RV  RV
  RD  BR  RD  RV  BR  RV  GR  GR  GR  GR  MT  GR  GR  GR  MT  CT  FR  RD  RD  BR 1FC  FR  RV
  RV  RV  BR  RV  MT  RD  CT  RD  FR  GR  RD  RD  RD  GR  GR  FR  MT  MT  CT  PI  RD  MT  PI
  RV  MT  RD  RD  CT  RD  GR  RD  RD  GR  CT  GR  RD  RD  RD  RD  GR  FR  FR  RV  BR  RV  RV
  PI  CT  MT  GR  GR  GR  FR  GR  RD  GR  GR  FR  GR  CT  GR  RD  RD  GR  MT  BR  BK  RV  AP
  PI  RD  GR  FR  GR  GR  RD  CT  RD  GR  GR  GR  GR  GR  MT  MT  LB  RD  FR  RV  RV  RV  RV
  RV  RD  RD  GR  CT  RD  RD  GR  GR  FR  GR  CT  MT  GR  GR  FR  GR  RD  GR  PI  FR  FC  RV
  PI  FR  CT  GR  GR  GR  FR  GR  GR  GR  RD  RD  GR  GR  MT  GR  MT  RD  CT  BR  RD  RD  RV
  PI  GR  PI  PI  FR  MT  GR  GR  TW  RD  RD  GR  RD  RD  TW  GR  GR  MT  FR  PI  PI  GR  PI
  RV  RD  RD  BR  CT  RD  MT  GR  MT  GR  GR  RD  RD  GR  GR  GR  FR  GR  GR  GR  CT  FR  PI
  RV  FC  FR  PI  GR  RD  GR  FR  GR  GR  MT  CT  GR  FR  GR  GR  RD  RD  CT  GR  RD  RD  RV
  RV  RV  RV  RV  FR  RD  LB  MT  MT  GR  GR  GR  GR  GR  RD  CT  RD  GR  GR  FR  GR  RD  PI
  AP  RV  BK  BR  MT  GR  RD  RD  GR  CT  GR  FR  GR  GR  RD  GR  FR  GR  GR  GR  MT  CT  PI
  RV  RV  BR  RV  FR  FR  GR  RD  RD  RD  RD  GR  CT  GR  RD  RD  GR  RD  CT  RD  RD  MT  RV
  PI  MT  RD  PI  CT  MT  MT  FR  GR  GR  RD  RD  RD  GR  FR  RD  CT  RD  MT  RV  BR  RV  RV
  RV  FR 0FC  BR  RD  RD  FR  CT  MT  GR  GR  GR  MT  GR  GR  GR  GR  RV  BR  RV  RD  BR  RD
  RV  RV  RV  RV  RV 0FC  RD  RD  GR  GR  CT  FR  RD  RD 0HQ  MT  FR  BR  CT  BR  BK  BR  CT
  PI  CT  MT  MT  RV  MT  MT  SH  SH  SH  RD  RD  RD  MT  RD  RD  RD  BR  RD  BR  RD  RV  RV
team, unit type, x, y (author: wyj_0081)
1, infantry, 20, 2
