  RF  SH  RF  SH  FR  GR  CT  GR  FR  GR  CT  RD  RD  RD  RD 0FC  RD  RD  SE  SE  RF
  SH  CT  SH  SH  GR  RD  RD  RD  RD  GR  GR  GR  FR  CT  PI  PI  PI  RD  BR  AP  SE
  RF  SH  SH  GR  CT  RD  FR  GR 0HQ  GR  FR  GR  GR  RD  RD  FR  BK  FC  SE  BR  SE
  SH  SH  GR  FR  GR  GR  GR  GR  RD  RD  RD  CT  GR  MT  RD  RD  PI  PI  SE  MT  SH
  FR  GR  CT  GR  RD  RD  CT  GR  FR  GR  GR  GR  FR  GR  GR  CT  ME  CT  RF 0FC  SH
  GR  RD  RD  GR  RD  FR  GR  GR  CT  GR  FR  GR  GR  GR  GR  GR  PI  RD  RD  FR  SH
  CT  RD  GR  GR  CT  GR  GR  RD  RD  RD  RD  RD  RD  RD  FR  GR  ME  GR  RD  CT  SH
  GR  RD  GR  FR  GR  GR  RD  CT  GR  GR  CT  GR  GR  CT  RD  GR  PI  GR  FR  GR  GR
  FR  RD  CT  GR  GR  TW  RD  GR  FR  GR  GR  GR  FR  GR  RD  GR  FR  RD  CT  RD  GR
  GR  GR  GR  GR  GR  GR  GR  GR  GR  SH  SH  SH  GR  GR  RD  GR  RD  RD  GR  RD  RD
  CT  GR  MT  GR  CT  GR  FR  GR  CT  SH  LB  SH  CT  GR  FR  GR  CT  GR  MT  GR  CT
  RD  RD  GR  RD  RD  GR  RD  GR  GR  SH  SH  SH  GR  GR  GR  GR  GR  GR  GR  GR  GR
  GR  RD  CT  RD  FR  GR  RD  GR  FR  GR  GR  GR  FR  GR  RD  TW  GR  GR  CT  RD  FR
  GR  GR  FR  GR  PI  GR  RD  CT  GR  GR  CT  GR  GR  CT  RD  GR  GR  FR  GR  RD  GR
  SH  CT  RD  GR  ME  GR  FR  RD  RD  RD  RD  RD  RD  RD  GR  GR  CT  GR  GR  RD  CT
  SH  FR  RD  RD  PI  GR  GR  GR  GR  GR  FR  GR  CT  GR  GR  FR  RD  GR  RD  RD  GR
  SH 1FC  RF  CT  ME  CT  GR  GR  FR  GR  GR  GR  FR  GR  CT  RD  RD  GR  CT  GR  FR
  SH  MT  SE  PI  PI  RD  RD  MT  GR  CT  RD  RD  RD  GR  GR  GR  GR  FR  GR  SH  SH
  SE  BR  SE  FC  BK  FR  RD  RD  GR  GR  FR  GR 1HQ  GR  FR  RD  CT  GR  SH  SH  RF
  SE  AP  BR  RD  PI  PI  PI  CT  FR  GR  GR  GR  RD  RD  RD  RD  GR  SH  SH  CT  SH
  RF  SE  SE  RD  RD 1FC  RD  RD  RD  RD  CT  GR  FR  GR  CT  GR  FR  SH  RF  SH  RF
team, unit type, x, y (author: wyj_0081)
1, infantry, 5, 20
